GGGcccccccccccccccccccccccccccccccccccccccccccccccccccccccccccccccccccccccccccccccccccccccccccGG
GGGcrrrrrrrrrrrrrrrrrrrrrrrrrrrrrrrrrrrrrrrrrrrrrrrrrrrrrrrrrrrrrrrrrrrrrrrrrrrrrrrrrrrrrrrrrcGG
GGGcFFFFFFFFFFFFFFFFFFFFFFFFFFFFFFFFFFFFFFFFFFFFFFFFFFFFFFFFFFFFFFFFFFFFFFFFFFFFFFFFFFFFFFFFFcGG
GGGcFrrrRRRrrrRRRrrrRRRrrrRRRrrrRRRrrrRRRrrrRRRrrrRRRrrrRRRrrrRRRrrrRRRrrrRRRrrrRRRrrrRRRrrrFcGG
GGGcFrrrRRRrrrRRRrrrRRRrrrRRRrrrRRRrrrRRRrrrRRRrrrRRRrrrRRRrrrRRRrrrRRRrrrRRRrrrRRRrrrRRRrrrFcGG
GGGcFrrrRRRrrrRRRrrrRRRrrrRRRrrrRRRrrrRRRrrrRRRrrrRRRrrrRRRrrrRRRrrrRRRrrrRRRrrrRRRrrrRRRrrrFcGG
GGGcFRRRrrrRRRrrrRRRrrrRRRrrrRRRrrrRRRrrrRRRrrrRRRrrrRRRrrrRRRrrrRRRrrrRRRrrrRRRrrrRRRrrrRRRFcGG
GGGcFRRRrrrRRRrrrRRRrrrRRRrrrRRRrrrRRRrrrRRRrrrRRRrrrRRRrrrRRRrrrRRRrrrRRRrrrRRRrrrRRRrrrRRRFcGG
GGGcFRRRrrrRRRrrrRRRrrrRRRrrrRRRrrrRRRrrrRRRrrrRRRrrrRRRrrrRRRrrrRRRrrrRRRrrrRRRrrrRRRrrrRRRFcGG
GGGcFrrrRRRrrrRRRrrrRRRrrrRRRrrrRRRrrrRRRrrrRRRrrrRRRrrrRRRrrrRRRrrrRRRrrrRRRrrrRRRrrrRRRrrrFcGG
GGGcFrrrRRRrrrRRRrrrRRRrrrRRRrrrRRRrrrRRRr7888888889RrrrRRRrrrRRRrrrRRRrrrRRRrrrRRRrrrRRRrrrFcGG
GGGcFrrrRRRrrrRRRrrrRRRrrrRRRrrrRRRrrrRRRr4505050504RrrrRRRrrrRRRrrrRRRrrrRRRrrrRRRrrrRRRrrrFcGG
GGGcFRRRrrrRRRrrrRRRrrrRRRrrrRRRrrrRRRrrrR4050505054rRRRrrrRRRrrrRRRrrrRRRrrrRRRrrrRRRrrrRRRFcGG
GGGcFRRRrrrRRRrrrRRRrrrRRRrrrRRRrrrRRRrrrR4505050504rRRRrrrRRRrrrRRRrrrRRRrrrRRRrrrRRRrrrRRRFcGG
GGGcFRRRrrrRRRrrrRRRrrrRRRrrrRRRrrrRRRrrrR4050505054rRRRrrrRRRrrrRRRrrrRRRrrrRRRrrrRRRrrrRRRFcGG
GGGcFrrrRRRrrrRRRrrrRRRrrrRRRrrrRRRrrrRRRr4505050504RrrrRRRrrrRRRrrrRRRrrrRRRrrrRRRrrrRRRrrrFcGG
GGGcFrrrRRRrrrRRRrrrRRRrrrRRRrrrRRRrrrRRRr4050505054RrrrRRRrrrRRRrrrRRRrrrRRRrrrRRRrrrRRRrrrFcGG
GGGcFrrrRRRrrrRRRrrrRRRrrrRRRrrrRRRrrrRRRr4505050504RrrrRRRrrrRRRrrrRRRrrrRRRrrrRRRrrrRRRrrrFcGG
GGGcFRRRrrrRRRrrrRRRrrrRRRrrrRRRrrrRRRrrrR4050505054rRRRrrrRRRrrrRRRrrrRRRrrrRRRrrrRRRrrrRRRFcGG
GGGcFRRRrrrRRRrrrRRRrrrRRRrrrRRRrrrRRRrrrR4505050504rRRRrrrRRRrrrRRRrrrRRRrrrRRRrrrRRRrrrRRRFcGG
GGGcFRRRrrrRRRrrrRRRrrrRRRrrrRRRrrrRRRrrrR4050505054rRRRrrrRRRrrrRRRrrrRRRrrrRRRrrrRRRrrrRRRFcGG
GGGcFrrrRRRrrrRRRrrrRRRrrrRRRrrrRRRrrrRRRr4505050504RrrrRRRrrrRRRrrrRRRrrrRRRrrrRRRrrrRRRrrrFcGG
GGGcFrrrRRRrrrRRRrrrRRRrrrRRRrrrRRRrrrRRRr4050505054RrrrRRRrrrRRRrrrRRRrrrRRRrrrRRRrrrRRRrrrFcGG
GGGcFrrrRRRrrrRRRrrrRRRrrrRRRrrrRRRrrrRRRr4505050504RrrrRRRrrrRRRrrrRRRrrrRRRrrrRRRrrrRRRrrrFcGG
GGGcFRRRrrrRRRrrrRRRrrrRRRrrrRRRrrrRRRrrrR4050505054rRRRrrrRRRrrrRRRrrrRRRrrrRRRrrrRRRrrrRRRFcGG
GGGcFRRRrrrRRRrrrRRRrrrRRRrrrRRRrrrRRRrrrR4505050504rRRRrrrRRRrrrRRRrrrRRRrrrRRRrrrRRRrrrRRRFcGG
GGGcFRRRrrrRRRrrrRRRrrrRRRrrrRRRrrrRRRrrrR4050505054rRRRrrrRRRrrrRRRrrrRRRrrrRRRrrrRRRrrrRRRFcGG
GGGcFrrrRRRrrrRRRrrrRRRrrrRRRrrrRRRrrrRRRr4505050504RrrrRRRrrrRRRrrrRRRrrrRRRrrrRRRrrrRRRrrrFcGG
GGGcFrrrRRRrrrRRRrrrRRRrrrRRRrrrRRRrrrRRRr1888888883RrrrRRRrrrRRRrrrRRRrrrRRRrrrRRRrrrRRRrrrFcGG
GGGcFrrrRRRrrrRRRrrrRRRrrrRRRrrrRRRrrrRRRrrrRRRrrrRRRrrrRRRrrrRRRrrrRRRrrrRRRrrrRRRrrrRRRrrrFcGG
GGGcFRRRrrrRRRrrrRRRrrrRRRrrrRRRrrrRRRrrrRRRrrrRRRrrrRRRrrrRRRrrrRRRrrrRRRrrrRRRrrrRRRrrrRRRFcGG
GGGcFRRRrrrRRRrrrRRRrrrRRRrrrRRRrrrRRRrrrRRRrrrRRRrrrRRRrrrRRRrrrRRRrrrRRRrrrRRRrrrRRRrrrRRRFcGG
GGGcFRRRrrrRRRrrrRRRrrrRRRrrrRRRrrrRRRrrrRRRrrrRRRrrrRRRrrrRRRrrrRRRrrrRRRrrrRRRrrrRRRrrrRRRFcGG
GGGcFFFFFFFFFFFFFFFFFFFFFFFFFFFFFFFFFFFFFFFFFFFFFFFFFFFFFFFFFFFFFFFFFFFFFFFFFFFFFFFFFFFFFFFFFcGG
GGGccccccccccccccccccccccccccccccccccccccccccccDccccccccccccccccccccccccccccccccccccccccccccccGG
GGGrrrrrrrrrrrrrrrrrrrrrrrrrrrrrrrrrrrrrrrrrrrrDrrrrrrrrrrrrrrrrrrrrrrrrrrrrrrrrrrrrrrrrrrrrrrGG
GGGGGGGGGGGGGGGGGGGGGGGGGGGGGGGGGGGGGGGGGGGGGGGGGGGGGGGGGGGGGGGGGGGGGGGGGGGGGGGGGGGGGGGGGGGGGGGG