GGGcccccccccccccccccccccccccccccccccccccccccccccccccccccccccccccccccccccccccccccccccccccccccccGG
GGGcUUUUUUUUUUUUUUUUUUUUUUUUUUUUUUUUUUUUUUUUUUUUUUUUUUUUUUUUUUUUUUUUUUUUUUUUUUUUUUUUUUUUUUUUUcGG
GGGcFFFFFFFFFFFFFFFFFFFFFFFFFFFFFFFFFFFFFFFFFFFFFFFFFFFFFFFFFFFFFFFFFFFFFFFFFFFFFFFFFFFFFFFFFcGG
GGGcFUUUcccUUUcccUUUcccUUUcccUUUcccUUUcccUUUcccUUUcccUUUcccUUUcccUUUcccUUUcccUUUcccUUUcccUUUFcGG
GGGcFUUUcccUUUcccUUUcccUUUcccUUUcccUUUcccUUUcccUUUcccUUUcccUUUcccUUUcccUUUcccUUUcccUUUcccUUUFcGG
GGGcFUUUcccUUUcccUUUcccUUUcccUUUcccUUUcccUUUcccUUUcccUUUcccUUUcccUUUcccUUUcccUUUcccUUUcccUUUFcGG
GGGcFcccUUUcccUUUcccUUUcccUUUcccUUUcccUUUcccUUUcccUUUcccUUUcccUUUcccUUUcccUUUcccUUUcccUUUcccFcGG
GGGcFcccUUUcccUUUcccUUUcccUUUcccUUUcccUUUcccUUUcccUUUcccUUUcccUUUcccUUUcccUUUcccUUUcccUUUcccFcGG
GGGcFcccUUUcccUUUcccUUUcccUUUcccUUUcccUUUcccUUUcccUUUcccUUUcccUUUcccUUUcccUUUcccUUUcccUUUcccFcGG
GGGcFUUUcccUUUcccUUUcccUUUcccUUUcccUUUcccUUUcccUUUcccUUUcccUUUcccUUUcccUUUcccUUUcccUUUcccUUUFcGG
GGGcFUUUcccUUUcccUUUcccUUUcccUUUcccUUUcccU7888888889cUUUcccUUUcccUUUcccUUUcccUUUcccUUUcccUUUFcGG
GGGcFUUUcccUUUcccUUUcccUUUcccUUUcccUUUcccU4505050504cUUUcccUUUcccUUUcccUUUcccUUUcccUUUcccUUUFcGG
GGGcFcccUUUcccUUUcccUUUcccUUUcccUUUcccUUUc4050505054UcccUUUcccUUUcccUUUcccUUUcccUUUcccUUUcccFcGG
GGGcFcccUUUcccUUUcccUUUcccUUUcccUUUcccUUUc4505050504UcccUUUcccUUUcccUUUcccUUUcccUUUcccUUUcccFcGG
GGGcFcccUUUcccUUUcccUUUcccUUUcccUUUcccUUUc4050505054UcccUUUcccUUUcccUUUcccUUUcccUUUcccUUUcccFcGG
GGGcFUUUcccUUUcccUUUcccUUUcccUUUcccUUUcccU4505050504cUUUcccUUUcccUUUcccUUUcccUUUcccUUUcccUUUFcGG
GGGcFUUUcccUUUcccUUUcccUUUcccUUUcccUUUcccU4050505054cUUUcccUUUcccUUUcccUUUcccUUUcccUUUcccUUUFcGG
GGGcFUUUcccUUUcccUUUcccUUUcccUUUcccUUUcccU4505050504cUUUcccUUUcccUUUcccUUUcccUUUcccUUUcccUUUFcGG
GGGcFcccUUUcccUUUcccUUUcccUUUcccUUUcccUUUc4050505054UcccUUUcccUUUcccUUUcccUUUcccUUUcccUUUcccFcGG
GGGcFcccUUUcccUUUcccUUUcccUUUcccUUUcccUUUc4505050504UcccUUUcccUUUcccUUUcccUUUcccUUUcccUUUcccFcGG
GGGcFcccUUUcccUUUcccUUUcccUUUcccUUUcccUUUc4050505054UcccUUUcccUUUcccUUUcccUUUcccUUUcccUUUcccFcGG
GGGcFUUUcccUUUcccUUUcccUUUcccUUUcccUUUcccU4505050504cUUUcccUUUcccUUUcccUUUcccUUUcccUUUcccUUUFcGG
GGGcFUUUcccUUUcccUUUcccUUUcccUUUcccUUUcccU4050505054cUUUcccUUUcccUUUcccUUUcccUUUcccUUUcccUUUFcGG
GGGcFUUUcccUUUcccUUUcccUUUcccUUUcccUUUcccU4505050504cUUUcccUUUcccUUUcccUUUcccUUUcccUUUcccUUUFcGG
GGGcFcccUUUcccUUUcccUUUcccUUUcccUUUcccUUUc4050505054UcccUUUcccUUUcccUUUcccUUUcccUUUcccUUUcccFcGG
GGGcFcccUUUcccUUUcccUUUcccUUUcccUUUcccUUUc4505050504UcccUUUcccUUUcccUUUcccUUUcccUUUcccUUUcccFcGG
GGGcFcccUUUcccUUUcccUUUcccUUUcccUUUcccUUUc4050505054UcccUUUcccUUUcccUUUcccUUUcccUUUcccUUUcccFcGG
GGGcFUUUcccUUUcccUUUcccUUUcccUUUcccUUUcccU4505050504cUUUcccUUUcccUUUcccUUUcccUUUcccUUUcccUUUFcGG
GGGcFUUUcccUUUcccUUUcccUUUcccUUUcccUUUcccU1888888883cUUUcccUUUcccUUUcccUUUcccUUUcccUUUcccUUUFcGG
GGGcFUUUcccUUUcccUUUcccUUUcccUUUcccUUUcccUUUcccUUUcccUUUcccUUUcccUUUcccUUUcccUUUcccUUUcccUUUFcGG
GGGcFcccUUUcccUUUcccUUUcccUUUcccUUUcccUUUcccUUUcccUUUcccUUUcccUUUcccUUUcccUUUcccUUUcccUUUcccFcGG
GGGcFcccUUUcccUUUcccUUUcccUUUcccUUUcccUUUcccUUUcccUUUcccUUUcccUUUcccUUUcccUUUcccUUUcccUUUcccFcGG
GGGcFcccUUUcccUUUcccUUUcccUUUcccUUUcccUUUcccUUUcccUUUcccUUUcccUUUcccUUUcccUUUcccUUUcccUUUcccFcGG
GGGcFFFFFFFFFFFFFFFFFFFFFFFFFFFFFFFFFFFFFFFFFFFFFFFFFFFFFFFFFFFFFFFFFFFFFFFFFFFFFFFFFFFFFFFFFcGG
GGGccccccccccccccccccccccccccccccccccccccccccccDccccccccccccccccccccccccccccccccccccccccccccccGG
GGGUUUUUUUUUUUUUUUUUUUUUUUUUUUUUUUUUUUUUUUUUUUUDUUUUUUUUUUUUUUUUUUUUUUUUUUUUUUUUUUUUUUUUUUUUUUGG
GGGGGGGGGGGGGGGGGGGGGGGGGGGGGGGGGGGGGGGGGGGGGGGGGGGGGGGGGGGGGGGGGGGGGGGGGGGGGGGGGGGGGGGGGGGGGGGG