GGGcccccccccccccccccccccccccccccccccccccccccccccccccccccccccccccccccccccccccccccccccccccccccGGGG
GGGcUUUUUUUUUUUUUUUUUUUUUUUUUUUUUUUUUUUUUUUUUUUUUUUUUUUUUUUUUUUUUUUUUUUUUUUUUUUUUUUUUUUUUUUcGGGG
GGGcFFFFFFFFFFFFFFFFFFFFFFFFFFFFFFFFFFFFFFFFFFFFFFFFFFFFFFFFFFFFFFFFFFFFFFFFFFFFFFFFFFFFFFFcGGGG
GGGcFcUcUcUcFFccUUccUUccFFUUcUUUcUUFFFFFFFFFFFFFFFFFFFFFFFFFFFFFFFFFFFFFFFFFFFFFFFFFFFFFFFFcGGGG
GGGcFUcUcUcUFFccUUccUUccFFUcccUcccUFFFFFFFFFFFFFFFFFFFFFFFFFFFFFFFFFFFFFFFFFFFFFFFFFFFFFFFFcGGGG
GGGcFcUcUcUcFFUUccUUccUUFFccUcccUccFFFFFFFFFFFFFFFFFFFFFFFFFFFFFFFFFFFFFFFFFFFFFFFFFFFFFFFFcGGGG
GGGcFUcUcUcUFFUUccUUccUUFFUcccUcccUFFFFFFFFFFFFFFFFFFFFFFFFFFFFFFFFFFFFFFFFFFFFFFFFFFFFFFFFcGGGG
GGGcFcUcUcUcFFccUUccUUccFFUUcUUUcUUFFFFFFFFFFFFFFFFFFFFFFFFFFFFFFFFFFFFFFFFFFFFFFFFFFFFFFFFcGGGG
GGGcFUcUcUcUFFccUUccUUccFFUcccUcccUFFFFFFFFFFFFFFFFFFFFFFFFFFFFFFFFFFFFFFFFFFFFFFFFFFFFFFFFcGGGG
GGGcFcUcUcUcFFUUccUUccUUFFccUcccUccFFFFFFcF788888889FcFFFFFFFFFFFFFFFFFFFFFFFFFFFFFFFFFFFFFcGGGG
GGGcFUcUcUcUFFUUccUUccUUFFUcccUcccUFFFFFFUF405050504FUFFFFFFFFFFFFFFFFFFFFFFFFFFFFFFFFFFFFFcGGGG
GGGcFcUcUcUcFFccUUccUUccFFUUcUUUcUUFFFFFFFF450505054FFFFFFFFFFFFFFFFFFFFFFFFFFFFFFFFFFFFFFFcGGGG
GGGcFUcUcUcUFFccUUccUUccFFUcccUcccUFFFFFFFF405050504FFFFFFFFFFFFFFFFFFFFFFFFFFFFFFFFFFFFFFFcGGGG
GGGcFcUcUcUcFFUUccUUccUUFFccUcccUccFFFFFFcF450505054FcFFFFFFFFFFFFFFFFFFFFFFFFFFFFFFFFFFFFFcGGGG
GGGcFUcUcUcUFFUUccUUccUUFFUcccUcccUFFFFFFUF405050504FUFFFFFFFFFFFFFFFFFFFFFFFFFFFFFFFFFFFFFcGGGG
GGGcFcUcUcUcFFccUUccUUccFFUUcUUUcUUFFFFFFFF450505054FFFFFFFFFFFFFFFFFFFFFFFFFFFFFFFFFFFFFFFcGGGG
GGGcFUcUcUcUFFccUUccUUccFFUcccUcccUFFFFFFFF405050504FFFFFFFFFFFFFFFFFFFFFFFFFFFFFFFFFFFFFFFcGGGG
GGGcFcUcUcUcFFUUccUUccUUFFccUcccUccFFFFFFcF450505054FcFFFFFFFFFFcccccccFFFFFFFFFFFFFFFFFFFFcGGGG
GGGcFUcUcUcUFFUUccUUccUUFFUcccUcccUFFFFFFUF405050504FUFFFFFFFFFFUUUUUUUFFFFFFFFFFFFFFFFFFFFcGGGG
GGGcFcUcUcUcFFccUUccUUccFFUUcUUUcUUFFFFFFFF450505054FFFFFFFFFFFFbcCCCcbFFFFFFFFFFFFFFFFFFFFcGGGG
GGGcFUcUcUcUFFccUUccUUccFFUcccUcccUFFFFFFFF405050504FFFFFFFFFFFFbcCCCcbFFFFFFFFFFFFFFFFFFFFcGGGG
GGGcFcUcUcUcFFUUccUUccUUFFccUcccUccFFFFFFcF450505054FcFFFFFFFFFFbcccccbFFFFFFFFFFFFFFFFFFFFcGGGG
GGGcFUcUcUcUFFUUccUUccUUFFUcccUcccUFFFFFFUF405050504FUFFFFFFFFFFbUUUUUbFFFFFFFFFFFFFFFFFFFFcGGGG
GGGcFcUcUcUcFFccUUccUUccFFUUcUUUcUUFFFFFFFF450505054FFFFFFFFFFFFbCCCCCbFFFFFFFFFFFFFFFFFFFFcGGGG
GGGcFUcUcUcUFFccUUccUUccFFUcccUcccUFFFFFFFF405050504FFFFFFFFFFFFwUUUUUwFFFFFFFFFFFFFFFFFFFFcGGGG
GGGcFcUcUcUcFFUUccUUccUUFFccUcccUccFFFFFFcF450505054FcFFFFFFFFFFFFFFFFFFFFFFFFFFFFFFFFFFFFFcGGGG
GGGcFUcUcUcUFFUUccUUccUUFFUcccUcccUFFFFFFUF405050504FUFFFFFFFFFFFFFFFFFFFFFFFFFFFFFFFFFFFFFcGGGG
GGGcFcUcUcUcFFccUUccUUccFFUUcUUUcUUFFFFFFFF450505054FFFFFFFFFFFFFFFFFFFFFFFFFFFFFFFFFFFFFFFcGGGG
GGGcFUcUcUcUFFccUUccUUccFFFFFFFFFFFFFFFFFFF405050504FFFFFFFFFFFFFFFFFFFFFFFFFFFFFFFFFFFFFFFcGGGG
GGGcFcUcUcUcFFUUccUUccUUFFFFFFFFFFFFFFFFFcF450505054FcFFFFFFFFFFFFFFFFFFFFFFFFFFFFFFFFFFFFFcGGGG
GGGcFUcUcUcUFFUUccUUccUUFFFFFFFFFFFFFFFFFUF188888883FUFFFFFFFFFFFFFFFFFFFFFFFFFFFFFFFFFFFFFcGGGG
GGGcFFFFFFFFFFFFFFFFFFFFFFFFFFFFFFFFFFFFFFFFFFFFFFFFFFFFFFFFFFFFFFFFFFFFFFFFFFFFFFFFFFFFFFFcGGGG
GGGcFFFFFFFFFFFFFFFFFFFFFFFFFFFFFFFFFFFFFFFFFFFFFFFFFFFFFFFFFFFFFFFFFFFFFFFFFFFFFFFFFFFFFFFcGGGG
GGGccccccccccccccccccccccccccccccccccccccccccccDccccccccccccccccccccccccccccccccccccccccccccGGGG
GGGUUUUUUUUUUUUUUUUUUUUUUUUUUUUUUUUUUUUUUUUUUUUDUUUUUUUUUUUUUUUUUUUUUUUUUUUUUUUUUUUUUUUUUUUUGGGG
GGGGGGGGGGGGGGGGGGGGGGGGGGGGGGGGGGGGGGGGGGGGGGGGGGGGGGGGGGGGGGGGGGGGGGGGGGGGGGGGGGGGGGGGGGGGGGGG
GGGGGGGGGGGGGGGGGGGGGGGGGGGGGGGGGGGGGGGGGGGGGGGGGGGGGGGGGGGGGGGGGGGGGGGGGGGGGGGGGGGGGGGGGGGGGGGG