GGGGGGGGGGGGGGGGGGGGGGGGGGGGGGGGGGGGGGGGG_CCCCC_GGGGGGGGGGGGGGGGGGGGGGGGGGGGGGGGGGGGGGGGGGGGGGGG
GGGGGWWWWWWWWWWWWWWWWWWWWWWWWWWWWWWWGGGGG_CCCCC_GGGGGGGGGGGGGGGGGGGGGGGGGGGGGGGGGGGGGGGGGGGGGGGG
GGGGWWWWWWWWWWWWWWWWWWWWWWWWWWWWWWWWWGGGGcCCCCCcGGGGGGGGGGGGGGGGGGGGGGGGGGGGGGGGGGGGGGGGGGGGGGGG
GGGWWWWWWWWWWWWWWWWWWWWWWWWWWWWWWWWWWWGGG_CCCCC_GGGGGGGGGGGGGGGGGGGGGGGGGGGGGGGGGGGGGGGGGGGGGGGG
GGGWWWWWWWWWWWWWWWWWWWWWWWWWWWWWWWWWWWGGG_CCCCC_GGGGGGGGGGGGGGGGGGGGGGGGGGGGGGGGGGGGGGGGGGGGGGGG
GGGWWWWWWWWWWWWWWWWWWWWWWWWWWWWWWWWWWWGGGcCCCCCcGGGGGGGGGGGGGGGGGGGGGGGGGGGGGGGGGGGGGGGGGGGGGGGG
GGGWWWWWWWWWWWWWWWWWWWWWWWWWWWWWWWWWWWGGG_CCCCC_GGGGGGGGGGGGGGGGGGGGGGGGGGGGGGGGGGGGGGGGGGGGGGGG
GGGWWWWWWWWWWWWWWWWWWWWWWWWWWWWWWWWWWWGGG_CCCCC_GGGGGGGGGGGGGGGGGGGGGGGGGGGGGGGGGGGGGGGGGGGGGGGG
___ccccccccccccccccccccccccccccccccccc___cCCCCCcGGGGGGGGGGccGGGGGGGGGGGGGGGGGGGGGGGGGGGGGGGGGGGG
CCCcccccccccccccccccDcccccccccccccccccCCCCCCCCC_GGGGGGGGGGccGGGGGGGGGGGGG##GGGGGGGGGG#GG#GGGGGGG
CCCCCCCCCCCCCCCCCCCCCCCCCCCCCCCCCCCCCCCCCCCCCCC_GGGGGGGGGGbbGGGGGGGGGGGGG##GGGGGGGGG######GGGGGG
CCCCCCCCCCCCCCCCCCCCCCCCCCCCCCCCCCCCCCCCCCCCCCCcGGGGGGGGGGbbGGGGGGGGGGGGG<>GGGGGGGGGGbGGbGGGGGGG
CCCCCCCCCCCCCCCCCCCCCCCCCCCCCCCCCCCCCCCCCCCCCCC_GGGGGGGGGGGGGGGGGGGGGGGGGGGGGGGGGGGGGGGGGGGGGGGG
CCCCCCCCCCCCCCCCCCCCCCCCCCCCCCCCCCCCCCCCCCCCCCC_GGGGGGGGGGGGGGGGGGGGGGGGGGGGGGGGGGGGGGGGGGGGGGGG
_____________________c___________________cCCCCCcCCCCCCCCCCCCCCCCCCCCCCCCCCCCCCCCCCCCCCCCCCCCCCCC
GGGGWWWWWWWWWWWWWGGGGGGGGWWWWWWWWWWWGGGGG_CCCCCCCCCCCCCCCCCCCCCCCCCCCCCCCCCCCCCCCCCCCCCCCCCCCCCC
GGGWWWWWWWWWWWWWWWGGGGGGWWWWWWWWWWWWWGGGG_CCCCCCCCCCCCCCCCCCCCCCCCCCCCCCCCCCCCCCCCCCCCCCCCCCCCCC
GGGWWWWWWWWWWWWWWWGGGGGGWWWWWWWWWWWWWGGGGcCCCCCcCCCCCCCCCCCCCCCCCCCCCCCCCCCCCCCCCCCCCCCCCCCCCCCC
GGGWWWWWWWWWWWWWWWGGGGGGWWWWWWWWWWWWWGGGG_CCCCCCCCCCCCCCCCCCcAAAAAAAAAAAAAAAAAAAAAAcCCCCCCCCCCCC
GGGWWWWWWWWWWWWWWWGGGGGGWWWWWWWWWWWWWGGGG_CCCCCCCCCCCCCCCCCC-AAAAAAAAAAAAAAAAAAAAAA-CCCCCCCCCCCC
GGGWWWWWWWWWWWWWWWGGGGGGWWWWWWWWWWWWWGGGGcCCCCCcCCCCCCCCCCCC-AAAAAAAAAAAAAAAAAAAAAA-CCCCCCCCCCCC
GGGWWWWWWWWWWWWWWWGGGGGGWWWWWWWWWWWWWGGGG_CCCCCCCCCCCCCCCCCCc----------------------cCCCCCCCCCCCC
GGGcccccccccccccccGGGGGGcccccccccccccGGGG_CCCCCCCCCCCCCCCCCCCCCCCCCCCCCCCCCCCCCCCCCCCCCCCCCCCCCC
___cccccccDccccccc______ccccccDcccccc____cCCCCCcCCCCCCCCCCCCCCCCCCCCCCCCCCCCCCCCCCCCCCCCCCCCCCCC
CCCCCCCCCCCCCCCCCCCCCCCCCCCCCCCCCCCCCCCCCCCCCCCCCCCCCCCCCCCCCCCCCCCCCCCCCCCCCCCCCCCCCCCCCCCCCCCC
CCCCCCCCCCCCCCCCCCCCCCCCCCCCCCCCCCCCCCCCCCCCCCCCCCCCCCCCCCCCCCCCCCCCCCCCCCCCCCCCCCCCCCCCCCCCCCCC
CCCCCCCCCCCCCCCCCCCCCCCCCCCCCCCCCCCCCCCCCCCCCCCcCCCCCCCCCCCCCCCCCCCCCCCCCCCCCCCCCCCCCCCCCCCCCCCC
CCCCCCCCCCCCCCCCCCCCCCCCCCCCCCCCCCCCCCCCCCCCCCCCCCCCCCCCCCCCCCCCCCCCCCCCCCCCCCCCCCCCCCCCCCCCCCCC
CCCCCCCCCCCCCCCCCCCCCCCCCCCCCCCCCCCCCCCCCCCCCCCCCCCCCCCCCCCCCCCCCCCCCCCCCCCCCCCCCCCCCCCCCCCCCCCC
ccccccccccccccccccccccccccccccccccccccccccCCCCCccccccccccccccccccccccccccccccccccccccccccccccccc
FFFFFFFFFFFFFFFFFFFFFFFFFFFFDFFFFFFFFFFFFcCCCCCcFFFFFFFFFFFFDFFFFFFFFFFFFFFFFFFFFFFFFFFFFFFFFFFF
cccccccccccccccccccccccccccccFFFFcFFFcFFFcCCCCCcFFFFcFFFcFFFcccccccccccccccccccccccccccccccccccc
GGGGGGGGGGGGGGGGGGGGGGGGGGGGcFFFFcccccFFFcCCCCCcFFFFcccccFFFcGGGGGGGGGGGGGGGGGGGGGGGGGGGGGGGGGGG
GGGGGGGGGGGGGGGGGGGGGGGGGGGGcFFFFFFFFFFFFcCCCCCcFFFFFFFFFFFFcGGGGGGGGGGGGGGGGGGGGGGGGGGGGGGGGGGG
GGGGGGGGGGGGGGGGGGGGGGGGGGGGccccccccccccccCCCCCccccccccccccccGGGGGGGGGGGGGGGGGGGGGGGGGGGGGGGGGGG
GGGGGGGGGGGGGGGGGGGGGGGGGGGGGGGGGGGGGGGbbbbbbbbbbbGGGGGGGGGGGGGGGGGGGGGGGGGGGGGGGGGGGGGGGGGGGGGG
GGGGGGGGGGGGGGGGGGGGGGGGGGGGGGGGGGGGGGGGGGbbbbbbbbbGGGGGGGGGGGGGGGGGGGGGGGGGGGGGGGGGGGGGGGGGGGGG