GGGGGGGGGGGGGGGGGGGGGGGGGGGGGGGGGGGGGGGGG_CCCCC_GGGGGGGGGGGGGGGGGGGGGGGGGGGGGGGGGGGGGGGGGGGGGGGG
GGGGGWWWWWWWWWWWWWWWWWWWWWWWWWWWWWWWGGGGG_CCCCC_GGGGGGGGGGGGGGGGGGGGGGGGGGGGGGGGGGGGGGGGGGGGGGGG
GGGGWWWWWWWWWWWWWWWWWWWWWWWWWWWWWWWWWGGGGcCCCCCcGGGGGGGGGGGGGGGGGGGGGGGGGGGGGGGGGGGGGGGGGGGGGGGG
GGGWWWWWWWWWWWWWWWWWWWWWWWWWWWWWWWWWWWGGG_CCCCC_GGGGGWWWWWWWWWWWWWWWWWWWWWWWWWWWWWWWWWWWWWWWGGGG
GGGWWWWWWWWWWWWWWWWWWWWWWWWWWWWWWWWWWWGGG_CCCCC_GGGGWWWWWWWWWWWWWWWWWWWWWWWWWWWWWWWWWWWWWWWWWGGG
GGGWWWWWWWWWWWWWWWWWWWWWWWWWWWWWWWWWWWGGGcCCCCCcGGGGWWWWWWWWWWWWWWWWWWWWWWWWWWWWWWWWWWWWWWWWWGGG
GGGWWWWWWWWWWWWWWWWWWWWWWWWWWWWWWWWWWWGGG_CCCCC_GGGGWWWWWWWWWWWWWWWWWWWWWWWWWWWWWWWWWWWWWWWWWGGG
GGGWWWWWWWWWWWWWWWWWWWWWWWWWWWWWWWWWWWGGG_CCCCC_GGGGWWWWWWWWWWWWWWWWWWWWWWWWWWWWWWWWWWWWWWWWWGGG
___ccccccccccccccccccccccccccccccccccc___cCCCCCcGGGGWWWWWWWWWWWWWWWWWWWWWWWWWWWWWWWWWWWWWWWWWGGG
CCCcccccccccccccccccDcccccccccccccccccCCCCCCCCC_GGGGcccccccccccccccccccccccccccccccccccccccccGGG
CCCCCCCCCCCCCCCCCCCCCCCCCCCCCCCCCCCCCCCCCCCCCCC_GGGGcccccccccccccccccccccccccccccccccccccccccGGG
CCCCCCCCCCCCCCCCCCCCCCCCCCCCCCCCCCCCCCCCCCCCCCCcGGGGcccccccccccccccccccccccccccccccccccccccccGGG
CCCCCCCCCCCCCCCCCCCCCCCCCCCCCCCCCCCCCCCCCCCCCCC_GGGGcccccccccccccccccccccccccccccccccccccccccGGG
CCCCCCCCCCCCCCCCCCCCCCCCCCCCCCCCCCCCCCCCCCCCCCCc____cccccccccccccccccccddccccccccccccccccccc____
_____________________c___________________cCCCCCCCCCCCCCCCCCCCCCCCCCCCCCCCCCCCCCCCCCCCCCCCCCCCCCC
GGGGWWWWWWWWWWWWWGGGGGGGGWWWWWWWWWWWGGGGG_CCCCCCCCCCCCCCCCCCCCCCCCCCCCCCCCCCCCCCCCCCCCCCCCCCCCCC
GGGWWWWWWWWWWWWWWWGGGGGGWWWWWWWWWWWWWGGGG_CCCCCCCCCCCCCCCCCCCCCCCCCCCCCCCCCCCCCCCCCCCCCCCCCCCCCC
GGGWWWWWWWWWWWWWWWGGGGGGWWWWWWWWWWWWWGGGGcCCCCCCCCCCCCCCCCCCCCCCCCCCCCCCCCCCCCCCCCCCCCCCCCCCCCCC
GGGWWWWWWWWWWWWWWWGGGGGGWWWWWWWWWWWWWGGGG_CCCCCCCCCCCCCCCCCCcAAAAAAAAAAAAAAAAAAAAAAcCCCCCCCCCCCC
GGGWWWWWWWWWWWWWWWGGGGGGWWWWWWWWWWWWWGGGG_CCCCCCCCCCCCCCCCCC-AAAAAAAAAAAAAAAAAAAAAA-CCCCCCCCCCCC
GGGWWWWWWWWWWWWWWWGGGGGGWWWWWWWWWWWWWGGGGcCCCCCCCCCCCCCCCCCC-AAAAAAAAAAAAAAAAAAAAAA-CCCCCCCCCCCC
GGGWWWWWWWWWWWWWWWGGGGGGWWWWWWWWWWWWWGGGG_CCCCCCCCCCCCCCCCCCc----------------------cCCCCCCCCCCCC
GGGcccccccccccccccGGGGGGcccccccccccccGGGG_CCCCCCCCCCCCCCCCCCCCCCCCCCCCCCCCCCCCCCCCCCCCCCCCCCCCCC
___cccccccDccccccc______ccccccDcccccc____cCCCCCCCCCCCCCCCCCCCCCCCCCCCCCCCCCCCCCCCCCCCCCCCCCCCCCC
CCCCCCCCCCCCCCCCCCCCCCCCCCCCCCCCCCCCCCCCCCCCCCCCCCCCCCCCCCCCCCCCCCCCCCCCCCCCCCCCCCCCCCCCCCCCCCCC
CCCCCCCCCCCCCCCCCCCCCCCCCCCCCCCCCCCCCCCCCCCCCCCCCCCCCCCCCCCCCCCCCCCCCCCCCCCCCCCCCCCCCCCCCCCCCCCC
CCCCCCCCCCCCCCCCCCCCCCCCCCCCCCCCCCCCCCCCCCCCCCCCCCCCCCCCCCCCCCCCCCCCCCCCCCCCCCCCCCCCCCCCCCCCCCCC
CCCCCCCCCCCCCCCCCCCCCCCCCCCCCCCCCCCCCCCCCCCCCCCCCCCCCCCCCCCCCCCCCCCCCCCCCCCCCCCCCCCCCCCCCCCCCCCC
CCCCCCCCCCCCCCCCCCCCCCCCCCCCCCCCCCCCCCCCCCCCCCCCCCCCCCCCCCCCCCCCCCCCCCCCCCCCCCCCCCCCCCCCCCCCCCCC
ccccccccccccccccccccccccccccccccccccccccccCCCCCccccccccccccccccccccccccccccccccccccccccccccccccc
FFFFFFFFFFFFFFFFFFFFFFFFFFFFDFFFFFFFFFFFFcCCCCCcFFFFFFFFFFFFDFFFFFFFFFFFFFFFFFFFFFFFFFFFFFFFFFFF
cccccccccccccccccccccccccccccFFFFcFFFcFFFcCCCCCcFFFFcFFFcFFFcccccccccccccccccccccccccccccccccccc
GGGGGGGGGGGGGGGGGGGGGGGGGGGGcFFFFcccccFFFcCCCCCcFFFFcccccFFFcGGGGGGGGGGGGGGGGGGGGGGGGGGGGGGGGGGG
GGGGGGGGGGGGGGGGGGGGGGGGGGGGcFFFFFFFFFFFFcCCCCCcFFFFFFFFFFFFcGGGGGGGGGGGGGGGGGGGGGGGGGGGGGGGGGGG
GGGGGGGGGGGGGGGGGGGGGGGGGGGGccccccccccccccCCCCCccccccccccccccGGGGGGGGGGGGGGGGGGGGGGGGGGGGGGGGGGG
GGGGGGGGGGGGGGGGGGGGGGGGGGGGGGGGGGGGGGGbbbbbbbbbbbGGGGGGGGGGGGGGGGGGGGGGGGGGGGGGGGGGGGGGGGGGGGGG
GGGGGGGGGGGGGGGGGGGGGGGGGGGGGGGGGGGGGGGGGGbbbbbbbbbGGGGGGGGGGGGGGGGGGGGGGGGGGGGGGGGGGGGGGGGGGGGG