GGGGGGGGGGGGGGGGGGGGGGGGGGGGGGGGGGGGGGGGGGCCCCCGGGGGGGGGGGGGGGGGGGGGGGGGGGGGGGGGGGGGGGGGGGGGGGGG
GGGGGGGGGGGGGGGGGGGGGGGGGGGGGGGGGGGGGGGGGGCCCCCGGGGGGGGGGGGGGGGGGGGGGGGGGGGGGGGGGGGGGGGGGGGGGGGG
GGGGGGGGGGGGGGGGGGGGGGGGGGGGGGGGGGGGGGGGGcCCCCCcGGGGGGGGGGGGGGGGGGGGGGGGGGGGGGGGGGGGGGGGGGGGGGGG
GGGGGGGGGGGGGGGGGGGGGGGGGGGGGGGGGGGGGGGGGGCCCCCGGGGGGGGGGGGGGGGGGGGGGGGGGGGGGGGGGGGGGGGGGGGGGGGG
GGGGGGGGGGGGGGGGGGGGGGGGGGGGGGGGGGGGGGGGGGCCCCCGGGGGGGGGGGGGGGGGGGGGGGGGGGGGGGGGGGGGGGGGGGGGGGGG
GGGGGGGGGGGGGGGGGGGGGGGGGGGGGGGGGGGGGGGGGcCCCCCcGGGGGGGGGGGGGGGGGGGGGGGGGGGGGGGGGGGGGGGGGGGGGGGG
GGGGGGGGGGGGGGGGGGGGGGGGGGGGGGGGGGGGGGGGGGCCCCCGGGGGGGGGGGGGGGGGGGGGGGGGGGGGGGGGGGGGGGGGGGGGGGGG
GGGGGGGGGGGGGGGGGGGGGGGGGGGGGGGGGGGGGGGGGGCCCCCGGGGGGGGGGGGGGGGGGGGGGGGGGGGGGGGGGGGGGGGGGGGGGGGG
GGGGGGGGGGGGGGGGGGGGGGGGGGGGGGGGGGGGGGGGGcCCCCCcGGGGGGGGGGGGGGGGGGGGGGGGGGGGGGGGGGGGGGGGGGGGGGGG
GGGGGGGGGGGGGGGGGGGGGGGGGGGGGGGGGGGGGGGGGGCCCCCGGGGGGGGGGGGGGGGGGGGGGGGGGGGGGGGGGGGGGGGGGGGGGGGG
GGGGGGGGGGGGGGGGGGGGGGGGGGGGGGGGGGGGGGGGGGCCCCCGGGGGGGGGGGGGGGGGGGGGGGGGGGGGGGGGGGGGGGGGGGGGGGGG
GGGGGGGGGGGGGGGGGGGGGGGGGGGGGGGGGGGGGGGGGcCCCCCcGGGGGGGGGGGGGGGGGGGGGGGGGGGGGGGGGGGGGGGGGGGGGGGG
GGGGGGGGGGGGGGGGGGGGGGGGGGGGGGGGGGGGGGGGGGCCCCCGGGGGGGGGGGGGGGGGGGGGGGGGGGGGGGGGGGGGGGGGGGGGGGGG
GGGGGGGGGGGGGGGGGGGGGGGGGGGGGGGGGGGGGGGGGGCCCCCGGGGGGGGGGGGGGGGGGGGGGGGGGGGGGGGGGGGGGGGGGGGGGGGG
GGGGGGGGGGGGGGGGGGGGGGGGGGGGGGGGGGGGGGGGGcCCCCCcCCCCCCCCCCCCCCCCCCCCCCCCCCCCCCCCCCCCCCCCCCCCCCCC
GGGWWWWWWWWWWWWWWWGGGGGGGWWWWWWWWWWWGGGGGGCCCCCCCCCCCCCCCCCCCCCCCCGGGGcccccGGGGCCCCCCCCCCCCCCCCC
GGGWWWWWWWWWWWWWWWGGGGGGWWWWWWWWWWWWWGGGGGCCCCCCCCCCCCCCCCCCCCCCCCGGGcAAAAAcGGGCCCCCCCCCCCCCCCCC
GGGWWWWWWWWWWWWWWWGGGGGGWWWWWWWWWWWWWGGGGcCCCCCcCCCCCCCCCCCCCCCCCCGGcAAAAAAAcGGCCCCCCCCCCCCCCCCC
GGGWWWWWWWWWWWWWWWGGGGGGWWWWWWWWWWWWWGGGGGCCCCCCCCCCCCCCCCCCCCCCCCGcAAAAAAAAAcGCCCCCCCCCCCCCCCCC
GGGWWWWWWWWWWWWWWWGGGGGGWWWWWWWWWWWWWGGGGGCCCCCCCCCCCCCCCCCCCCCCCCcAAAAAAAAAAAcCCCCCCCCCCCCCCCCC
GGGWWWWWWWWWWWWWWWGGGGGGWWWWWWWWWWWWWGGGGcCCCCCcCCCCCCCCCCCCCCCCCCcAAAAAAAAAAAcCCCCCCCCCCCCCCCCC
GGGWWWWWWWWWWWWWWWGGGGGGWWWWWWWWWWWWWGGGGGCCCCCCCCCCCCCCCCCCCCCCCCcAAAAAcAAAAAcCCCCCCCCCCCCCCCCC
GGGcccccccccccccccGGGGGGcccccccccccccGGGGGCCCCCCCCCCCCCCCCCCCCCCCCcAAAAAAAAAAAcCCCCCCCCCCCCCCCCC
ccccccccccDcccccccccccccccccccDccccccGGGGcCCCCCcCCCCCCCCCCCCCCCCCCcAAAAAAAAAAAcCCCCCCCCCCCCCCCCC
CCCCCCCCCCCCCCCCCCCCCCCCCCCCCCCCCCCCCCCCCCCCCCCCCCCCCCCCCCCCCCCCCCGcAAAAAAAAAcGCCCCCCCCCCCCCCCCC
CCCCCCCCCCCCCCCCCCCCCCCCCCCCCCCCCCCCCCCCCCCCCCCCCCCCCCCCCCCCCCCCCCGGcAAAAAAAcGGCCCCCCCCCCCCCCCCC
CCCCCCCCCCCCCCCCCCCCCCCCCCCCCCCCCCCCCCCCCCCCCCCcCCCCCCCCCCCCCCCCCCGGGcAAAAAcGGGCCCCCCCCCCCCCCCCC
CCCCCCCCCCCCCCCCCCCCCCCCCCCCCCCCCCCCCCCCCCCCCCCCCCCCCCCCCCCCCCCCCCGGGGcccccGGGGCCCCCCCCCCCCCCCCC
CCCCCCCCCCCCCCCCCCCCCCCCCCCCCCCCCCCCCCCCCCCCCCCCCCCCCCCCCCCCCCCCCCCCCCCCCCCCCCCCCCCCCCCCCCCCCCCC
ccccccccccccccccccccccccccccccccccccccccccCCCCCccccccccccccccccccccccccccccccccccccccccccccccccc
FFFFFFFFFFFFFFFFFFFFFFFFFFFFDFFFFFFFFFFFFcCCCCCcFFFFFFFFFFFFDFFFFFFFFFFFFFFFFFFFFFFFFFFFFFFFFFFF
cccccccccccccccccccccccccccccFFFFcFFFcFFFcCCCCCcFFFFcFFFcFFFcccccccccccccccccccccccccccccccccccc
GGGGGGGGGGGGGGGGGGGGGGGGGGGGcFFFFcccccFFFcCCCCCcFFFFcccccFFFcGGGGGGGGGGGGGGGGGGGGGGGGGGGGGGGGGGG
GGGGGGGGGGGGGGGGGGGGGGGGGGGGcFFFFFFFFFFFFcCCCCCcFFFFFFFFFFFFcGGGGGGGGGGGGGGGGGGGGGGGGGGGGGGGGGGG
GGGGGGGGGGGGGGGGGGGGGGGGGGGGccccccccccccccCCCCCccccccccccccccGGGGGGGGGGGGGGGGGGGGGGGGGGGGGGGGGGG
GGGGGGGGGGGGGGGGGGGGGGGGGGGGGGGGGGGGGGGGGGGGGGGbbbGGGGGGGGGGGGGGGGGGGGGGGGGGGGGGGGGGGGGGGGGGGGGG
GGGGGGGGGGGGGGGGGGGGGGGGGGGGGGGGGGGGGGGGGGGGGGGGGbbGGGGGGGGGGGGGGGGGGGGGGGGGGGGGGGGGGGGGGGGGGGGG