GGG###GGG###GGG###GGG###GGG###GGG###GGG###GGG###GGG###GGG###GGG###GGG###GGG###GGG###GGG###GGG###
#G#####G#####G#####G#####G#####G#####G#####G#####G#####G#####G#####G#####G#####G#####G#####G####
#G#####G#####G#####G#####G#####G#####G#####G#####G#####G#####G#####G#####G#####G#####G#####G####
GGGWWWGGGWWWGGGWWWGGGWWWGGGWWWGGGWWWGGGWWWGGGWWWGGGWWWGGGWWWGGGWWWGGGWWWGGGWWWGGGWWWGGGWWWGGGWWW
###GGG###GGG###GGG###GGG###GGGGGGGGGGGGGGGWWGGGGGGGGGGGGGGGG###GGG###GGG###GGG###GGG###GGG###GGG
####G#####G#####G#####G#####GGGGGGGGGGGGGWWWWGGGGGGGGGGGGGG#####G#####G#####G#####G#####G#####G#
####G#####G#####G#####G#####GGGGGGGGGGGGWWWWWWGGGGGGGGGGGGG#####G#####G#####G#####G#####G#####G#
WWWGGGWWWGGGWWWGGGWWWGGGWWWGGGGGGGGGGGGWWWWWWWWGGGGGGGGGGGGGWWWGGGWWWGGGWWWGGGWWWGGGWWWGGGWWWGGG
GGG###GGG###GGG###GGG###GGGGGGGGGGGGGGWWWWWWWWWWGGGGGGGGGGGGGGG###GGG###GGG###GGG###GGG###GGG###
#G#####G#####G#####G#####GGGGGGGGGGGGWWWWWWWWWWWWGGGGGGGGGGGGG#####G#####G#####G#####G#####G####
#G#####G#####G#####G#####GGGGGGGGGGGWWWWWWDDWWWWWWGGGGGGGGGGGG#####G#####G#####G#####G#####G####
GGGWWWGGGWWWGGGWWWGGGWWWGGGGGGGGGGGGGGGGGGGGGGGGGGGGGGGGGGGGGGGWWWGGGWWWGGGWWWGGGWWWGGGWWWGGGWWW
###GGG###GGG###GGG###GGG###GGGGGGGGGGGGGGGeeGGGGGGGGGGGGGGGG###GGG###GGG###GGG###GGG###GGG###GGG
####G#####G#####G#####G#####GGGGGGGGGGGGGeeeeGGGGGGGGGGGGGG#####G#####G#####G#####G#####G#####G#
####G#####G#####G#####G#####GGGGGGGGGGGGwwwwwwGGGGGGGGGGGGG#####G#####G#####G#####G#####G#####G#
WWWGGGWWWGGGWWWGGGWWWGGGWWWGGGGGGGGGGGGGGGGGGGGGGGGGGGGGGGGGWWWGGGWWWGGGWWWGGGWWWGGGWWWGGGWWWGGG
GGGGGGGGGGGGGGGGGGGGGGGGGGGGGGGGG###GGG###GGG###GGG###GGG###GGG###GGG###GGGGGGGGGGGGGGGGGGGGGGGG
GGGGGGGGGGGgggggggggggGGGGGGGGGG#####G#####G#####G#####G#####G#####G#####GGGGgggGGGGGGGGGGGGGGGG
GGGGGGGGgggWWWWWWWWWWWggggGGGGGG#####G#####G#####G#####G#####G#####G#####ggggWWWgggGGGGGGGGGGGGG
GGGGGGggWWWAAAAAAAAAAAWWWWggggGGGWWWGGGWWWGGGWWWGGGWWWGGGWWWGGGWWWGGGWWWGWWWWAAAWWWggggggGGGGGGG
ggggggWWAAAAAAAAAAAAAAAAAAWWWWgggggggggggGGGGGGGGGGGGGGGGGGGggggggggggggWAAAAAAAAAAWWWWWWggggggg
WWWWWWAAAAAAAAAAAAAAAAAAAAAAAAWWWWWWWWWWWgggggggGGGGGGggggggWWWWWWWWWWWWAAAAAAAAAAAAAAAAAWWWWWWW
AAAAAAAAAAAAAAAAAAAAAAAAAAAAAAAAAAAAAAAAAWWWWWWWggggggWWWWWWAAAAAAAAAAAAAAAAAAAAAAAAAAAAAAAAAAAA
AAAAAAAAAAAAAAAAAAAAAAAAAAAAAAAAAAAAAAAAAAAAAAAAWWWWWWAAAAAAAAAAAAAAAAAAAAAAAAAAAAAAAAAAAAAAAAAA
AAAAAAAAAAAAAAAAAAAAAAAAAAAAAAAAAAAAAAAAAAAAAAAAAAAAAAAAAAAAAAAAAAAAAAAAAAAAAAAAAAAAAAAAAAAAAAAA
AAAAAAAAAAAAAAAAGGGAAAAAAAAAAAAAAAAAAAAAAAAAAAAAAAAAAAAAAAAAAAAAAAAAAAAAAAAAAAAAAAAAAAAAAAAAAAAA
AAAAAAAAAAAAGGGGGGGGGGGAAAAAAAAAAAAAAAAAAAAAAAAAAAAAAAAAAAAAAAAAAAAAAAAAAAAAAAAAAAAAAAAAAAAAAAAA
AAAAAAAAAGGGGGGGGGGGGGGGGGGAAAAAAAAAAAAAAAAAAAAAAAAAAAAAAAAAAAAAAAAAAAAAAAAAAAGGGGGGGAAAAAAAAAAA
AAAAAGGGGGGGGGGGGGGGGGGGGGGGGGAAAAAAAAAAAAAAAAAAAAAAAAAAAAAAAAAAAAAAAAAAGGGGGGGGGGGGGGGGGGAAAAAA
GGGGGGGGGGGGGGGGGGGGGGGGGGGGGGGGGGGGAAAAAAAAAAAAAAAAAAAAAAAAAAAAGGGGGGGGGGGGGGGGGGGGGGGGGGGGGGGG
GGGGGGGGGGGGGGGGGGGGGGGGGGGGGGGGGGGGGGGGGGGGAAAAAAAAAAAAAAAGGGGGGGGGGGGGGGGGGGGGGGGGGGGGGGGW____
GGGGGGGGGGGGGGGGGGGGGGGGGGGGGGGGGGGGGGGGGGGGGGGGGAAAAAGGGGGGGGGGGGGGGGGGGGGGGGGGGGGGGGGGGGG_GGGG
GGGGGGGGGGGGGGGGGGGGGGGGGGGGGGGGGGGGGGGGGGGGGGGGGGGGGGGGGGGGGGGGGGGGGGGGGGGGGGGGGGGGGGGGGGG_Gfff
GGGGGGGGGGGGGGGGGGGGGGGGGGGGGGGGGGGGGGGGGGGGGGGGGGGGGGGGGGGGGGGGGGGGGGGGGGGGGGGGGGGGGGGGGGG_Gfff
GGGGGGGGGGGGGGGGGGGGGGGGGGGGGGGGGGGGGGGGGGGGGGGGGGGGGGGGGGGGGGGGGGGGGGGGGGGGGGGGGGGGGGGGGGG_Gfff
GGGGGGGGGGGGGGGGGGGGGGGGGGGGGGGGGGGGGGGGGGGGGGGGGGGGGGGGGGGGGGGGGGGGGGGGGGGGGGGGGGGGGGGGGGG_Gfff
GGGGGGGGGGGGGGGGGGGGGGGGGGGGGGGGGGGGGGGGGGGGGGGGGGGGGGGGGGGGGGGGGGGGGGGGGGGGGGGGGGGGGGGGGGG_Gfff