################################################################################################
################################################################################################
################################################################################################
################################################################################################
################################################################################################
################################################################################################
################################################################################################
################################################################################################
################################################################################################
################################################################################################
#########################AAAAAAAAAAAAAAAAAAAAAAAAAAAAAAAAAAAAAAAAAAAAA##########################
#########################A                                           A##########################
#########################A                                           A##########################
#########################A            Welcome to RPG.PY              A##########################
#########################A                                           A##########################
#########################A        Select an option to right          A##########################
#########################A             to get started                A##########################
#########################A                                           A##########################
#########################A                                           A##########################
#########################A                                           A##########################
#########################AAAAAAAAAAAAAAAAAAAAAAAAAAAAAAAAAAAAAAAAAAAAA##########################
################################################################################################
################################################################################################
################################################################################################
################################################################################################
################################################################################################
################################################################################################
################################################################################################
################################################################################################
################################################################################################
################################################################################################
################################################################################################
################################################################################################
################################################################################################
################################################################################################
################################################################################################
################################################################################################