GGGGGGGGGGGGGGGGGGGGGGGGGGGGGGGGGGTGGGGGGGGGGGGGGGbbGGGGGGGGGGGGGGGGGGGGGGGGGGGGGGGGGGGGGGGGGGGG
GGGGGGGGGGGGGGGGGGGGGGGGGGGGGGGGGGGGGGGGGGGGGGGGGGGbbGGGGGGGGGGGGGGGGGGGGGGGGGGGGGGGGGGGGGGGGGGG
GGGGGGGGGGGGGGGGGGGGGGGGGGGGGGGGGGGGGGGGGGGGGGGGGGGGbbGGGGGGGGGGGGGGGGGGGGGGGGGGGGGGGGGGGGGGGGGG
GGGGGGGGGGGGGGGGGGGGGGGGGGGGGGGGGGGGGGGGGGGGGGGGGGGGGbbGGGGGGGGGGGGGGGGGGGGGGGGGGGGGGGGGGGGGGGGG
GGGGGGGGGGGGTGGGGGGTGGGGGGGGGGGGGGGGGGGGGGGGGGGGGGGGGGbbGGGGGGGGGGGGGGGGGGGGGGGGGGGGGGGGGGGGGGGG
GGGGGGGGGGGGGGGGGGGGGGGGGGTGGGGGGGGGGGGGGGGGGGGGGGGGGGGbbGGGGGGGGGGGGGGGGGGGGGGGGGGGGGGGGGGGGGGG
GGGGGGGGGGGGGGGGTGGGGGGGGGGGGGGGGGGGGGGGGGGGGGGGGGGGGGGGbbGGGGGGGGGGGGGGGGGGGGGGGGGGGGGGGGGGGGGG
GGGGGGGGGTGGGGGGGGGGGTGGGGGGGGGGGGGGGGGGGGGGGGGGGGGGGGGGGbbGGGGGGGGGGGGGGGGGGggggggGGGGGGGGGGGGG
GGGGGGGGGGGGGGGGGGGGGTGGGGTGGGGGGGGGGGGGGGGGGGGGGGGGGGGGGGbbGGGGGGGGGGGGGGGGGggggggGGGGGGGGGGGGG
GGGGGGGGGGGGGGGGGGGGGGGGGGGGGGGGGGGGGGGGGGGGGGGGGGGGGGGGGGGbbGGGGGGGGGGGGGGGGggggggGGGGGGGGGGGGG
GGGGGGGGGGGGGGGGGGTGGGGGGGGGGGGGGGGGGGGGGWWWWWGGGGGGGGGGGGGGbbGGGGGGGGGGGGGGGggggggGGGGGGGGGGGGG
GGGGGGGGGTGGGGGGGGGGGGGGGGGGGGGGGGGGGGGGGWWWWWGGGGGGGGGGGGGGGbbGGGGGGGGGGGGGGGGGGGGGGGGGGGGGGGGG
GGGGGGGGGGGGGGGGGGGGGGGGGGGGGGGGGGGGGGGGGWWWWWWWWWWWGGGGGGGGGbbGGGGGGGGGGGGGGGGGGGGGGGGGGGGGGGGG
GGGGGGGGGGGGGGGGGGGGGGGGTGGGGGGGGGGGGGGGGWWWWWWWWWWWGGGGGGGGGbbGGGGGGGGGGGGGGGGGGGGGGGGGGGGGGGGG
GGGGGGGGGGGGGGGGGGGGGGGGGGGGGGGGGGGGGGGGGWWWWWWWWWWWGGGGGGGGGGbbGGGGGGGGGGGGGGGGGGGGGGGGGGGGGGGG
GGGGGGGGGGGGGGGGGGGGGGGGGGGGGGGGGGGGGGGGGWWWWWWWWWWWGGGGGGGGGGGbbGGGGGGGGGGGGGGGGGGGGGGGGGGGGGGG
GGGGGGGGGGGGGGGGGGGGGGGGGGGGGGGGGGGGGGGGGWWWWWDWWWWWGGGGGGGGGGGGbbGGGGGAAAAGGGGGGGGGGGGGGGGGGGGG
GGGGGGGGGGGGGGGGGGGGGGGGGGGGGGGGGGGGGGGGGGGGGGGGGGGGGGGGGGGGGGGGGbbGAAAAAAAAAGGGGGGGGGGGGGGGGGGG
GGGGGGGGGAAAAAGGGGGGGGGGGGGGGGGGGGGGGGGAAAAAAAAGGGGGGGGGGGGGGGGGbbbAAAAAAAAAAAAAAGGGGGGGGGGGGGGG
GGGGGGGGAAAAAAAGGGGGGGGGGGGGGGGGGGGGAAAAAAAAAAAAAAGGGGGGGGAAAAAAAAbbbAAAAAAAAAAAAAAAAAGGGGGGGGGG
GGGGAAAAAAAAAAAAAGGGGGGGGGGGGGGAAAAAAAAAAAAAAAAAAAAAAAAAAAAAAAAAAAAbbbAAAAAAAAAAAAAAAAAAAAAAAAAA
AAAAAAAAAAAAAAAAAAAAGGGGGGGGGAAAAAAAAAAAAAAAAAAAAAAAAAAAAAAAAAAAAAGGbbbGGGGAAAAAAAAAAAAAAAAAAAAA
AAAAAAAAAAAAAAAAAAAAAAAGGGGAAAAAAAAAAAAAAAAAAAAAAAAAAAAAAAAAAAAGGGGGGGGGGGGGAAAAAAAAAAAAAAAAAAAA
AAAAAAAAAAAAAAAAAAAAAAAbbbbAAAAAAAAAAAAAAAAAAAAAAAAAAAAAAAAAAGGGGGGGGGGGGGGGGAAAAAAAAAAAAAAAAAAA
AAAAAAAAAAAAAAAAAAAAAAAbbbbAAAAAAAAAAAAAAAAAGAAAAAAAAAAAAAAAAAAGGGGGGGGGGGGGAAAAAAAAAAAAAAAAAAAA
AAAAAAAAAAAAGAAAAAAAAAAbbbbAAAAAAAAAAAAAAGGGGGAAAAAAAAAAAAAAAAAAAAAGGGGGGGbbbAAAAAAAAAAAAAAAAAAA
AAAAAAAAAAGGGAAAAAAAAAAAAAAAAAAAAAAAAAGGGGGGGGGGAAAAAAAAAAAAAAAAAAAAAAAAAAAbbbAAAAAAAAAAAAAAAAAA
AAAAAAGGGGGGGGGGGGAAAAAAAAAAAAGGGGGGGGGGGGGGGGGGGGGGGGGGGGGAAAAAAAAAAAAAAAAAbbbAAAAAAAAGGGGGGGGG
AAAAGGGGGGGGGGGGGGGGAAAAAAAAGGGGGGGGGGGGGGGGGGGGGGGGGGGGGGGGGGAAAAAAAAAAAAAAAbbbAAAGGGGGGGGGGGGG
GGGGGGGGGGGGGGGGGGGGGGGGGGGGGGGGGGGGGGGGGGGGGGGGGGGGGGGGGGGGGGGGGGGAAAAAAAAAAAbGGGGGGGGGGGGGGGGG
GGGGGGGGGGGGGGGGGGGGGGGGGGGGGGGGGGGGGGGGGGGGGGGGGGGGGGGGGGGGGGGGGGGGGGGAAAAAGGGGGGGGGGGGGGGGGGGG
GGGGGGGGGGGGGGGGGGGGGGGGGGGGGGGGGGGGGGGGGGGGGGGGGGGGGGGGGGGGGGGGGGGGGGGGGAGGGGGGGGGGGGGGGGGGGGGG
GGGGGGGGGGGGGGGGGGGGGGGGGGGGGGGGGGGGGGGGGGGGGGGGGGGGGGGGGGGGGGGGGGGGGGGGGGGGGGGGGGGGGGGGGGGGGGGG
GGGGGGGGGGGGGGGGGGGGGGGGGGGGGGGGGGGGGGGGGGGGGGGGGGGGGGGGGGGGGGGGGGGGGGGGGGGGGGGGGGGGGGGGGGGGGGGG
GGGGGGGGGGGGGGGGGGGGGGGGGGGGGGGGGGGGGGGGGGGGGGGGGGGGGGGGGGGGGGGGGGGGGGGGGGGGGGGGGGGGGGGGGGGGGGGG
GGGGGGGGGGGGGGGGGGGGGGGGGGGGGGGGGGGGGGGGGGGGGGGGGGGGGGGGGGGGGGGGGGGGGGGGGGGGGGGGGGGGGGGGGGGGGGGG
GGGGGGGGGGGGGGGGGGGGGGGGGGGGGGGGGGGGGGGGGGGGGGGGGGGGGGGGGGGGGGGGGGGGGGGGGGGGGGGGGGGGGGGGGGGGGGGG