GGGGGGGGGGGGGGGGGGGGGGGGGGGGGGGGGGGGGGGGGGGGGGGGGGbbGGGGGGGGGGGGGGGGGGGGGGGGGGGGGGGGGGGGGGGGGGGG
GGGGGGGGGGGGGGGGGGGGGGGGGGGGGGGGGGGGGGGGGGGGGGGGGGGbbGGGGGGGGGGGGGGGGGGGGGGGGGGGGGGGGGGGGGGGGGGG
GGGGGGGGGGGGGGGGGGGGGGGGGGGGGGGGGGGGGGGGGGGGGGGGGGGGbbGGGGGGGGGGGGGGGGGGGGGGGGGGGGGGGGGGGGGGGGGG
GGGGGGGGGGGGGGGGGGGGGGGGGGGGGGGGGGGGGGGGGGGGGGGGGGGGGbbGGGGGGGGGGGGGGGGGGGGGGGGGGGGGGGGGGGGGGGGG
GGGGGGGGGGGGGGGGGGGGGGGGGGGGGGGGGGGGGGGGGGGGGGGGGGGGGGbbGGGGGGGGGGGGGWWWWWWWGGGGGGGGGGGGGGGGGGGG
GGGGGGGGGGGGGGGGGGGGGGGGGGGGGGGGGGGGGGGGGGGGGGGGGGGGGGGbbGGGGGGGGGGGWWWWWWWWWGGGGGGGGGGGGGGGGGGG
GGGGGGGGGGGGGGGGGGGGGGGGGGGGGGGGGGGGGGGGGGGGGGGGGGGGGGGGbbGGGGGGGGGGGcccccccGGGGGGGGGGGGGGGGGGGG
GGGGGGGGGGGGGGGGGGGGGGGGGGGGGGGGGGGGGGGGGGGGGGGGGGGGGGGGGbbGGGGGGGGGGcccDcccGGGGGGGGGGGGGGGGGGGG
GGGGGGGGGGGGGGGGGGGGGGGGGGGGGGGGGGGGGGGGGGGGGGGGGGGGGGGGGGbbGGGGGGGGGGGGGGGGGGGGGGGGGGGGGGGGGGGG
GGGGGGGGGGGGGGGGGGGGGGGGGGGGGGGGGGGGGGGGGGGGGGGGGGGGGGGGGGGbbGGGGGGGGGGGGGGGGGGGGGGGGGGGGGGGGGGG
GGGGGGGGGGGGGGGGGGGGGGGGGGGGGGGGGGGGGGGGGGGGGGGGGGGGGGGGGGGGbbGGGGGGGGGGGGGGGGGGGGGGGGGGGGGGGGGG
GGGGGGGGGGGGGGGGGGGGGGGGGGGGGGGGGGGGGGGGGGGGGGGGGGGGGGGGGGGGGbbGGGGGGGGGGGGGGGGGGGGGGGGGGGGGGGGG
GGGGGGGGGGGGGGGGGGGGGGGGGGGGGGGGGGGGGGGGGWWWWWWWWWWWGGGGGGGGGbbGGGGGGGGGGGGGGGGGGGGGGGGGGGGGGGGG
GGGGGGGGGGGGGGGGGGGGGGGGGGGGGGGGGGGGGGGGGWWWWWWWWWWWGGGGGGGGGbbGGGGGGGGGGGGGGGGGGGGGGGGGGGGGGGGG
GGGGGGGGGGGGGGGGGGGGGGGGGGGGGGGGGGGGGGGGWWWWWWWWWWWWWGGGGGGGGGbbGGGGGGGGGGGGGGGGGGGGGGGGGGGGGGGG
GGGGGGGGGGGGGGGGGGGGGGGGGGGGGGGGGGGGGGGGGcccccccccccGGGGGGGGGGGbbGGGGGGGGGGGGGGGGGGGGGGGGGGGGGGG
GGGGGGGGGGGGGGGGGGGGGGGGGGGGGGGGGGGGGGGGGcccccDcccccGGGGGGGGGGGGbbGGGGGWWWWGGGGGGGGGGGGGGGGGGGGG
GGGGGGGGGGGGGGGGGGGGGGGGGGGGGGGGGGGGGGGGGGGGGGGGGGGGGGGGGGGGGGGGGbbGWWWAAAAWWGGGGGGGGGGGGGGGGGGG
GGGGGGGGGWWWWWGGGGGGGGGGGGGGGGGGGGGGGGGWWWWWWWWGGGGGGGGGGGGGGGGGbbbWAAAAAAAAAWWWWGGGGGGGGGGGGGGG
GGGGGGGGWAAAAAWGGGGGGGGGGGGGGGGGGGGGWWWAAAAAAAAWWWGGGGGGGGWWWWWWUUbbbAAAAAAAAAAAAWWWWWGGGGGGGGGG
GGGGWWWWAAAAAAAWWGGGGGGGGGGGGGGWWWWWAAAAAAAAAAAAAAWWWWWWWWAAAAAAAAUbbbAAAAAAAAAAAAAAAAWWWWWWWWWW
WWWWAAAAAAAAAAAAWWWWGGGGGGGGGWWAAAAAAAAAAAAAAAAAAAAAAAAAAAAAAAAAAAGGbbbGGGGAAAAAAAAAAAAAAAAAAAAA
AAAAAAAAAAAAAAAAAAAAWWWGGGGWWAAAAAAAAAAAAAAAAAAAAAAAAAAAAAAAAAAGGGGGGGGGGGGGAAAAAAAAAAAAAAAAAAAA
AAAAAAAAAAAAAAAAAAAAAAAbbbbAAAAAAAAAAAAAAAAAAAAAAAAAAAAAAAAAAGGGGGGGGGGGGGGGGAAAAAAAAAAAAAAAAAAA
AAAAAAAAAAAAAAAAAAAAAAAbbbbAAAAAAAAAAAAAAAAAGAAAAAAAAAAAAAAAAWWGGGGGGGGGGGGGWAAAAAAAAAAAAAAAAAAA
AAAAAAAAAAAAGAAAAAAAAAAbbbbAAAAAAAAAAAAAAGGGGGAAAAAAAAAAAAAAAAAWWWWGGGGGGGbbbAAAAAAAAAAAAAAAAAAA
AAAAAAAAAAGGGAAAAAAAAAAUAAUAAAAAAAAAAAGGGGGGGGGGAAAAAAAAAAAAAAAAAAAWWWWWWWUbbbAAAAAAAAAAAAAAAAAA
AAAAAAGGGGGGGGGGGGAAAAAAAAAAAAGGGGGGGGGGGGGGGGGGGGGGGGGGGGGAAAAAAAAAAAAAAAAUbbbAAAAAAAAGGGGGGGGG
AAAAGGGGGGGGGGGGGGGGAAAAAAAAGGGGGGGGGGGGGGGGGGGGGGGGGGGGGGGGGGAAAAAAAAAAAAAAUbbbAAAGGGGGGGGGGGGG
GGGGGGGGGGGGGGGGGGGGGGGGGGGGGGGGGGGGGGGGGGGGGGGGGGGGGGGGGGGGGGGGGGGAAAAAAAAAAUbbbGGGGGGGGGGGGGGG
GGGGGGGGGGGGGGGGGGGGGGGGGGGGGGGGGGGGGGGGGGGGGGGGGGGGGGGGGGGGGGGGGGGGGGGAAAAAGGGbbbGGGGGGGGGGGGGG
GGGGGGGGGGGGGGGGGGGGGGGGGGGGGGGGGGGGGGGGGGGGGGGGGGGGGGGGGGGGGGGGGGGGGGGGGAGGGGGGbbbGGGGGGGGGGGGG
GGGGGGGGGGGGGGGGGGGGGGGGGGGGGGGGGGGGGGGGGGGGGGGGGGGGGGGGGGGGGGGGGGGGGGGGGGGGGGGGGbbGGGGGGGGGGGGG
GGGGGGGGGGGGGGGGGGGGGGGGGGGGGGGGGGGGGGGGGGGGGGGGGGGGGGGGGGGGGGGGGGGGGGGGGGGGGGGGGGbbbGGGGGGGGGGG
GGGGGGGGGGGGGGGGGGGGGGGGGGGGGGGGGGGGGGGGGGGGGGGGGGGGGGGGGGGGGGGGGGGGGGGGGGGGGGGGGGGbbbGGGGGGGGGG
GGGGGGGGGGGGGGGGGGGGGGGGGGGGGGGGGGGGGGGGGGGGGGGGGGGGGGGGGGGGGGGGGGGGGGGGGGGGGGGGGGGGbbbGGGGGGGGG
GGGGGGGGGGGGGGGGGGGGGGGGGGGGGGGGGGGGGGGGGGGGGGGGGGGGGGGGGGGGGGGGGGGGGGGGGGGGGGGGGGGGGbbbGGGGGGGG