GGGGGGGGGGGGGGGGGGGGGGGGGGGGGGGGGGGGGGGGGGGGGGGGGGGGGGGGGGGGGGGGGGGGGGGGGGGGGGGGGGGGGGGGGGGGGGGG
GGGGGGGGGGGGGGGGGGGGGGGGGGGGGGGGGGGGGGGGGGGGGGGGGGGGGGGGGGGGGGGGGGGGGGGGGGGGGGGGGGGGGGGGGGGGGGGG
GGGGGGGGGGGGGGGGGGGGGGGGGGGGGGGGGGGGGGGGGGGGGGGGGGGGGGGGGGGGGGGGGGGGGGGGGGGGGGGGGGGGGGGGGGGGGGGG
GGGGGGGGGGGGGGGGGGGGGGGGGGGGGGGGGGGGGGGGGGGGGGGGGGGGGGGGGGGGGGGGGGGGGGGGGGGGGGGGGGGGGGGGGGGGGGGG
GGGGGGGGGGGGGGGGGGGGGGGGGGGGGGGGGGGGGGGGGGGGGGGGGGGGGGGGGGGGGGGGGGGGGGGGGGGGGGGGGGGGGGGGGGGGGGGG
GGGGGGGGGGGGGGGGGGGGGGGGGGGGGGGGGGGGGGGGGGGGGGGGGGGGGGGGGGGGGGGGGGGGGGGGGGGGGGGGGGGGGGGGGGGGGGGG
GGGGGGGGGGGGGGGGGGGGGGGGGGGGGGGGGGGGGGGGGGGGGGGGGGGGGGGGGGGGGGGGGGGGGGGGGGGGGGGGGGGGGGGGGGGGGGGG
GGGGGGGGGGGGGGGGGGGGGGGGGGGGGGGGGGGGGGGGGGGGGGGGGGGGGGGGGGGGGGGGGGGGGGGGGGGGGGGGGGGGGGGGGGGGGGGG
GGGGGGGGGGGGGGGGGGGGGGGGGGGGGGGGGGGGGGGGGGGGGGGGGGGGGGGGGGGGGGGGGGGGGGGGGGGGGGGGGGGGGGGGGGGGGGGG
GGGGGGGGGGGGGGGGGGGGGGGGGGGGGGGGGGGGGGGGGGGGGGGGGGGGGGGGGGGGGGGGGGGGGGGGGGGGGGGGGGGGGGGGGGGGGGGG
GGGGGGGGGGGGGGGGGGGGGGGGGGGGGGGGGGGGGGGGGGGGGGGGGGGGGGGGGGGGGGGGGGGGGGGGGGGGGGGGGGGGGGGGGGGGGGGG
GGGGGGGGGGGGGGGGGGGGGGGGGGGGGGGGGGGGGGGGGGGGGGGGGGGGGGGGGGGGGGGGGGGGGGGGGGGGGGGGGGGGGGGGGGGGGGGG
GGGGGGGGGGGGGGGGGGGGGGGGGGWWWWWWWWWWWWWWWWWWWWWWWWWWWWWWWWWWWWWGGGGGGGGWWWWWWWWWWWWWWWWWWWWWWGGG
GGGGGGGGGGGGGGGGGGGGGGGGGGWFFFFFFFFFFFFFFFFFFFFFFFFFFFFFFFFFFFWGGGGGGGGWFFFFFFFFFFFFFFFFFFFFWGGG
GGGGGGGGGGGGGGGGGGGGGGGGGGWFFFFFFFFFFFFFFFFFFFFFFFFFFFFFFFFFFFWGGGGGGGGWFFFFFFFFFFFFFFFFFFFFWGGG
GGGGGGGGGGGGGGGGGGGGGGGGGGWFFFFFFFFFFFFFFFFFFFFFFFFFFFFFFFFFFFWGGGGGGGGWFFFFFFFFFFFFFFFFFFFFWGGG
GGGGGGGGGGGGGGGGGGGGGGGGGGWFFFFFFFFFFFFFFFFFFFFFFFFFFFFFFFFFFFWGGGGGGGGWFFFFFFFFFFFFFFFFFFFFWGGG
GGGGGGGGGGGGGGGGGGGGGGGGGGWFFFFFFFFFFFFFFFFFFFFFFFFFFFFFFFFFFFWWWWWWWWWWFFFFFFFFFFFFFFFFFFFFWGGG
GGGGGGGGGGGGGGGGGGGGGGGGGGWFFFFFFFFFFFFFFFFFFFFFFFFFFFFFFFFFFFFFFFFFFFFFFFFFFFFFFFFFFFFFFFFFWGGG
GGGGGGGGGGGGGGGGGGGGGGGGGGWFFFFFFFFFFFFFFFFFFFFFFFFFFFFFFFFFFFWWWWWWWWWWFFFFFFFFFFFFFFFFFFFFWGGG
GGGGGGGGGGGGGGGGGGGGGGGGGGWFFFFFFFFFFFFFFFFFFFFFFFFFFFFFFFFFFFWGGGGGGGGWFFFFFFFFFFFFFFFFFFFFWGGG
GGGGGGGGGGGGGGGGGGGGGGGGGGWFFFFFFFFFFFFFFFFFFFFFFFFFFFFFFFFFFFWGGGGGGGGWFFFFFFFFFFFFFFFFFFFFWGGG
GGGGGGGGGGGGGGGGGGGGGGGGGGWFFFFFFFFFFFFFFFFFFFFFFFFFFFFFFFFFFFWGGGGGGGGWFFFFFFFFFFFFFFFFFFFFWGGG
GGGGGGGGGGGGGGGGGGGGGGGGGGWWWWWWWWWWWWWWWWWWWWDWWWWWWWWWWWWWWWWGGGGGGGGWFFFFFFFFFFFFFFFFFFFFWGGG
GGGGGGGGGGGGGGGGGGGGGGGGGGGGGGGGGGGGGGGGGGGGGGGGGGGGGGGGGGGGGGGGGGGGGGGWFFFFFFFFFFFFFFFFFFFFWGGG
GGGGGGGGGGGGGGGGGGGGGGGGGGGGGGGGGGGGGGGGGGGGGGGGGGGGGGGGGGGGGGGGGGGGGGGWFFFFFFFFFFFFFFFFFFFFWGGG
GGGGGGGGGGGGGGGGGGGGGGGGGGGGGGGGGGGGGGGGGGGGGGGGGGGGGGGGGGGGGGGGGGGGGGGWFFFFFFFFFFFFFFFFFFFFWGGG
GGGGGGGGGGGGGGGGGGGGGGGGGGGGGGGGGGGGGGGGGGGGGGGGGGGGGGGGGGGGGGGGGGGGGGGWFFFFFFFFFFFFFFFFFFFFWGGG
GGGGGGGGGGGGGGGGGGGGGGGGGGGGGGGGGGGGGGGGGGGGGGGGGGGGGGGGGGGGGGGGGGGGGGGWFFFFFFFFFFFFFFFFFFFFWGGG
GGGGGGGGGGGGGGGGGGGGGGGGGGGGGGGGGGGGGGGGGGGGGGGGGGGGGGGGGGGGGGGGGGGGGGGWFFFFFFFFFFFFFFFFFFFFWGGG
GGGGGGGGGGGGGGGGGGGGGGGGGGGGGGGGGGGGGGGGGGGGGGGGGGGGGGGGGGGGGGGGGGGGGGGWFFFFFFFFFFFFFFFFFFFFWGGG
GGGGGGGGGGGGGGGGGGGGGGGGGGGGGGGGGGGGGGGGGGGGGGGGGGGGGGGGGGGGGGGGGGGGGGGWFFFFFFFFFFFFFFFFFFFFWGGG
GGGGGGGGGGGGGGGGGGGGGGGGGGGGGGGGGGGGGGGGGGGGGGGGGGGGGGGGGGGGGGGGGGGGGGGWFFFFFFFFFFFFFFFFFFFFWGGG
GGGGGGGGGGGGGGGGGGGGGGGGGGGGGGGGGGGGGGGGGGGGGGGGGGGGGGGGGGGGGGGGGGGGGGGWFFFFFFFFFFFFFFFFFFFFWGGG
GGGGGGGGGGGGGGGGGGGGGGGGGGGGGGGGGGGGGGGGGGGGGGGGGGGGGGGGGGGGGGGGGGGGGGGWFFFFFFFFFFFFFFFFFFFFWGGG
GGGGGGGGGGGGGGGGGGGGGGGGGGGGGGGGGGGGGGGGGGGGGGGGGGGGGGGGGGGGGGGGGGGGGGGWFFFFFFFFFFFFFFFFFFFFWGGG
GGGGGGGGGGGGGGGGGGGGGGGGGGGGGGGGGGGGGGGGGGGGGGGGGGGGGGGGGGGGGGGGGGGGGGGWWWWWWWWWWWDWWWWWWWWWWGGG