AAAAAAAAAAAWGGGGGGGGGGGGGGG###GGG###GGG###GGG###GGG###GGG###GGG###GGG###GGG###GGG###GGG###GGG###
AAAAAAAAAAAAWGGGGGGGGGGGGG#####G#####G#####G#####G#####G#####G#####G#####G#####G#####G#####G####
AAAAAAAAAAAAAWWGGWWGGGGGGG#####G#####G#####G#####G#####G#####G#####G#####G#####G#####G#####G####
AAAAAAAAAAAAAAAWWAAWGGGGGGGWWWGGGWWWGGGWWWGGGWWWGGGWWWGGGWWWGGGWWWGGGWWWGGGWWWGGGWWWGGGWWWGGGWWW
AAAAAAAAAAAAAAAAAAAAWGGGGGGGGGGGGGGGGGGGGG###GGG###GGG###GGG###GGG###GGG###GGG###GGG###GGG###GG#
AAAAAAAAAAAAAAAAAAAAAWGGGGGGGGGGGGGGGGGGG#####G#####G#####G#####G#####G#####G#####G#####G####G##
AAAAAAAAAAAAAAAAAAAAAAWWGGGGGGGGGGGGGGGGG#####G#####G#####G#####G#####G#####G#####G#####G####G##
AAAAAAAAAAAAAAAAAAAAAAAAWWWGGGGGGGGGGGGGGGWWWGGGWWWGGGWWWGGGWWWGGGWWWGGGWWWGGGWWWGGGWWWGGGWWWGGW
AAAAAAAAAAAAAAAAAAAAAAAAAAAGGGGGGGGGGGGGGGGGG###GGG###GGG###GGG###GGG###GGG###GGG###GGG###GGG###
AAAAAAAAAAAAAAAAAAAAAAAAAAAWWWGGGGGGGGGGGGGG#####G#####G#####G#####G#####G#####G#####G#####G####
AAAAAAAAAAAAAAAAAAAAAAAAAAAAAAGGGGGGGGGGGGGG#####G#####G#####G#####G#####G#####G#####G#####G####
AAAAAAAAAAAAAAAAAAAAAAAAAAAAAAWWWGGGGGGGGGGGGWWWGGGWWWGGGWWWGGGWWWGGGWWWGGGWWWGGGWWWGGGWWWGGGWWW
AAAAAAAAAAAAAAAAAAAAAAAAAAAAAAAAAWWWGGGGGGGGGGGG###GGG###GGG###GGG###GGG###GGG###GGG###GGG###GGG
AAAAAAAAWWWWWWWWWWWWWWWWWWAAAAAAAAAAWGGGGGGGGGG#####G#####G#####G#####G#####G#####G#####G#####G#
AAAAWWWWFFFFFFFFFFFFFFFFFFWWAAAAAAAAWWWGGGGGGGG#####G#####G#####G#####G#####G#####G#####G#####G#
AAAWFFFFFFFFFFFFFFFFFFFFFFFFWWWWAAAAAAAbbbbbGGGGWWWGGGWWWGGGWWWGGGWWWGGGWWWGGGWWWGGGWWWGGGWWWGGG
AAAWFFFFFFFFFFFFFFFFFFFFFFFFWWUUAAAAAAAbbbbbWWWGGGGGGGGGGGGGGGGGGGGGGGGGGGGGGGGGGGGGGGGGGGGGGGGG
AAAUWWWWFFFFFFFFFFFFFFFFFFWWUUAAAAAAAAAbbbbbAAAWGGGGGGGGGGGGGGGGGGGGGGGGGGGGGGGGGGGGGGGGGGGGGGGG
AAAAUUUUWWWWWWWWWWFWWWWWWWUUAAAAAAAAAAAbbbbbAAAAWGGGGGGGGGGGGGGGGGGGGGGGGGGGGGGGGGGGGGGGGGGGGGGG
AAAAAAAAUUUUUUUUUUbUUUUUUUAAAAAAAAAAAAAbbbbbAAAAAWGGGGGGGGGGGGGGGGGGGGGGGGGGGGGGGGGGGGGGGGGGGGGG
AAAAAAAAAAAAAAAAAAbAAAAAAAAAAAAAAAAAAAAbbbbbAAAAAAWGGGGGGGGGGGGGGGGGGGGGGGGGGGGGGGGGGGGGGGGGGGGg
AbbbbbbbbbbbbbbbbbbbbbbbbbbbbbbbbbbbbbbbbbbbAAAAAAAWWWWWWWWGGGGGGGGGGGGGGGGGGGGGGGGGGWWWWWWWWWWW
AbbbbbbbbbbbbbbbbbbbbbbbbbbbbbbbbbbbbbbbbbbbAAAAAAAAAAAAAAAWWWGGGGGGGGGGGGGGGGGGGGWWWAAAAAAAAAAA
AbbbbbbbbbbbbbbbbbbbbbbbbbbbbbbbbbbbbbbbbbbbAAAAAAAAAAAAAAAAAAWWWWWWWWWWWWWWWWWWWWAAAAAAAAAAAAAA
AbbbbbbbbbbbbbbbbbbbbbbbbbbbbbbbbbbbbbbbbbbbAAAAAAAAAAAAAAAAAAAAAAAAAAAAAAAAAAAAAAAAAAAAAAAAAAAA
AUAAAAAAAAAAAAAAAAAAUAAAAAAAAAAAAAAAAAAUAAAUAAAAAAAAAAAAAAAAAAAAAAAAAAAAAAAAAAAAAAAAAAAAAAAAAAAA
AAAAAAAAAAAAAAAAAAAAAAAAAAAAAAAAAAAAAAAAAAAAAAAAAAAAAAAAAAAAAAAAAAAAAAAAAAAAAAAAAAAAAAAAAAAAAAAA
AAAAAAAAAAAAAAAAAAAAAAAAAAAAAAAAAAAAAAAAAAAAAAAAAAAAAAAAAAAAAAAAAAAAAAAAAAAAAAAAAAAAAAAAAAAAAAAA
AAAAAAAAAAAAAAAAAAAAAAAAAAAAAAAAAAAAAAAAAAAAAAAAAAAAAAAAAAAAAAAAAAAAAAAAAAAAAAAAAAAAAAAAAAAAAAAA
AAAAAAAAAAAAAAAAAAAAAAAAAAAAAAAAAAAAAAAAAAAAAAAAAAAAAAAAAAAAAAAAAAAAAAAAAAAAAAAAAAAAAAAAAAAAAGGG
AAAAAAAAAAAAAAAAAAAAAAAAAAAAAAAAAAAAAAAAAAAAAAAAAAAAAAAAAAAAAAAAAAAAAAAAAAAAAAAAAAAAAAAAAAGGGGGG
AAAAAAAAAAAAAAAAAAAAAAAAAAAAAAAAAAAAAAAAAAAAAAAAAAAAAAAAAAAAAAAAAAAAAAAAAGGGGGGGGGGGGGGGGGGGGGGG
AAAAAAAAAAAAAAAAAAAAAAAAAAAAAAAAAAAAAAAAAAAAAAAAAAAAAAAAAAAAGGGGGGGGGGGGGGGGGGGGGGGGGGGGGGGGGGGG
AAAAAAAAAAAAAAAAAAAAAAAAAAAAAAAAAAAAAAAAAAAAAAAAAAAGGGGGGGGGGGGGGGGGGGGGGGGGGGGGGGGGGGGGGGGGGGGG
AAAAAAAAAAAAAAAAAAAAAAAAAAAAAAAAAAAAAAAAAAAAAAAAAAAGGGGGGGGGGGGGGGGGGGGGGGGGGGGGGGGGGGGGGGGGGGGG
AAAAAAAAAAAAAAAAAAAAAAAAAAAAAAAAAAAAAAAAAAAAAAAAAAAGGGGGGGGGGGGGGGGGGGGGGGGGGGGGGGGGGGGGGGGGGGGG
AAAAAAAAAAAAAAAAAAAAAAAAAAAAAAAAAAAAAAAAAAAAAAGGGGGGGGGGGGGGGGGGGGGGGGGGGGGGGGGGGGGGGGGGGGGGGGGG