GGGGGGGGGGGGGGGGGGGGGGGGGGGGGGGGGGGGGGGGGGGGGGGGGGGGGGGGGGGGGGGGGGGGGGGGGGGGGGGGGGGGGGGGGGGGGGGG
GGGWWWWWWWWWWWWWWWWWWWWWWWWWWWWWWWWWWWWWc__________________________________________________cGGGG
GGGWUUUUUUUUUUUUUUUUUUUUUUUUUUUUUUUUUUUWGGGGFFFFFFFGGGGGGGGGGGGGGGGGGGGGGGGGGGGGGGGGGGGGGGG_GGGG
GGGWFFFFFFFFFFFFFFFFFFFFFFFFFFFFFFFFFFFWGGGGUUUUUUUGGGGGGGGGGGGGGGGGGGGGGGGGGGGGGGGGGGGGGGG_GGGG
GGGWFFFFFFFFFFFFFFFFFFFFFFFFFFFFFFFFFFFWGGGGGGGGGGGGGGGGGGGGGGGGGGGGGGGGGGGGGGGGGGGGGGGGGGG_GGGG
GGGWFFFFFFFFFFFFFFFFFFFFFFFFFFFFFFFFFFFWGGGGGGGGGGGGGGGGGGGGGGGGGGGGGGGGGGGGGGGGGGGGGGGGGGG_GGGG
GGGWFFFFFFFFFFFFFFFFFFFFFFFFFFFFFFFFFFFWGGGGGGGGGGGGGGGGGGGGGGGGGGGGGGGGGGGGGGGGGGGGGGGGGGG_GGGG
GGGWFFFFFFFFFFFFFFFFFFFFFFFFFFFFFFFFFFFWGGGGGGGGGGGGGGGGGGGGGGGGGGGGGGGGGGGGGGGGGGGGGGGGGGG_GGGG
GGGWFFFFFFFFFFFFFFFFFFFFFFFFFFFFFFFFFFFWGGGGGGGGGGGGGGGGGGGGGGGGGGGGGGGGGGGGGGGGGGGGGGGGGGG_GGGG
GGGWFFFFFFFFFFFFFFFFFFFFFFFFFFFFFFFFFFFWGGGGGGGGGGGGGGGGGGGGGGGGGGGGGGGGGGGGGGGGGGGGGGGGGGG_GGGG
GGGWFFFFFFFFFFFFFFFFFFFFFFFFFFFFFFFFFFFWGGGGGGGGGGGGGGGGGGGGGGGGGGGGGGGGGGGGGGGGGGGGGGGGGGG_GGGG
GGGWFFFFFFFFFFFFFFFFFFFFFFFFFFFFFFFFFFFWGGGGGGGGGGGGGGGGGGGGGGGGGGGGGGGGGGGGGGGGGGGGGGGGGGGcGGGG
GGGWFFFFFFFFFFFFFFFFFFFFFFFFFFFFFFFFFFFWWWWWWWWGGGWWWWWWWWWWWWWWWWWWWWWWWWWWWWWWWWWWWWWWWWWWGGGG
GGGWFFFFFFFFFFFFFFFFFFFFFFFFFFFFFFFFFFFUUUUUUUUFFFUUUUUUUUUUWUUUUUUUUUUUUUUUUUUUUUUUUUUUUUUWGGGG
GGGWFFFFFFFFFFFFFFFFFFFFFFFFFFFFFFFFFFFFFFFFFFFFFFFFFFFFFFFFWFFFFFFFFFWWWWWWWWFFFFFFFFFFFFFWGGGG
GGGWFFFFFFFFFFFFFFFFFFFFFFFFFFFFFFFFFFFFFFFFFFFFFFFFFFFFFFFFWFFFFFFFFFWWWWWWWWFFFFFFFFFFFFFWGGGG
GGGWFFFFFFFFFFFFFFFFFFFFFFFFFFFFFFFFFFFFFFFFFFFFFFFFFFFFFFFFWFFFFFFFFFWWWWWWWWFFFFFFFFFFFFFWGGGG
GGGWFFFFFFFFFFFFFFFFFFFFFFFFFFFFFFFFFFFFFFFFFFFFFFFFFFFFFFFFWFFFFFFFFFUFFFFFFUFFFFFFFFFFFFFWGGGG
GGGWFFFFFFFFFFFFFFFFFFFFFFFFFFFFFFFFFFFFFFFFFFFFFFFFFFFFFFFFWFFFFFFFFFFFFFFFFFFFFFFFFFFFFFFWGGGG
GGGWFFFFFFFFFFFFFFFFFFFFFFFFFFFFFFFFFFFFFFFFFFFFFFFFFFFFFFFFWFFFFFFFFFFFFFFFFFFFFFFFFFFFFFFWGGGG
GGGWFFFFFFFFFFFFFFFFFFFFFFFFFFFFFFFFFFFFFFFFFFFFFFFFFFFFFFFFWFFFFFFFFFFFFFFFFFFFFFFFFFFFFFFWGGGG
GGGWFFFFFFFFFFFFFFFFFFFFFFFFFFFFFFFFFFFFFFFFFFFFFFFFFFFFFFFFWFFFFFFFFFFFFFFFFFFFFFFFFFFFFFFWGGGG
GGGWFFFFFFFFFFFFFFFFFFFFFFFFFFFFFFFFFFFFFFFFFFFFFFFFFFFFFFFFWWWWWFFWWWWWWWWWWWWWWWWWWWWWWWWWGGGG
GGGWFFFFFFFFFFFFFFFFFFFFFFFFFFFFFFFFFFFFFFFFFFFFFFFFFFFFFFFFUUUUUFFUUUUUUUUUUUWUUUUUUUUUUUUWGGGG
GGGWWWWWWWWWWWWWWFFWWWWWWWWWWWWWWWWWWWWWWWWWWWFFFFFFFFFFFFFFFFFFFFFFFFFFFFFFFFWFFFFFFFFFFFFWGGGG
GGGWUUUUUUUUUUUUUFFUUUUUUUUUUUUUWUUUUUUUUUUUUUFFFFFFFFFFFFFFFFFFFFFFFFFFFFFFFFWFFFFFFFFFFFFWGGGG
GGGWFFFFFFFFFFFFFFFFFFFFFFFFFFFFWFFFFFFFFFFFFFFFFFFFFFFFFFFFFFFFFFFFFFFFFFFFFFWFFFFFFFFFFFFWGGGG
GGGWFFFFFFFFFFFFFFFFFFFFFFFFFFFFWFFFFFFFFFFFFFFFFFFFFFFFFFFFFFFFFFFFFFFFFFFFFFUFFFFFFFFFFFFWGGGG
GGGWFFFFFFFFFFFFFFFFFFFFFFFFFFFFWFFFFFFFFFFFFFFFFFFFFFFFFFFFFFFFFFFFFFFFFFFFFFFFFFFFFFFFFFFWGGGG
GGGWFFFFFFFFFFFFFFFFFFFFFFFFFFFFWFFFFFFFFFFFFFFFFFFFFFFFFFFFFFFFFFFFFFFFWWWWWWWFFFFFFFFFFFFWGGGG
GGGWFFFFFFFFFFFFFFFFFFFFFFFFFFFFWFFFFFFFFFFFFFFFFFFFFFFFFFFFFFFFFFFFFFFFUUUUUUWFFFFFFFFFFFFWGGGG
GGGWFFFFFFFFFFFFFFFFFFFFFFFFFFFFWFFFFFFFFFFFFFFFFFFFFFFFFFFFFFFFFFFFFFFFFFFFFhWFFFFFFFFFFFFWGGGG
GGGWFFFFFFFFFFFFFFFFFFFFFFFFFFFFWFFFFFFFFFFFFFFFFFFFFFFFFFFFFFFFFFFFFFFFFFFFFhWFFFFFFFFFFFFWGGGG
GGGWWWWWWWWWWWWWWWWWWWWWWWWWWWWWWWWWWWWWWWWWWWWDWWWWWWWWWWWWWWWWWWWWWWWWWWWWWWWWWWWWWWWWWWWWGGGG
GGGUUUUUUUUUUUUUUUUUUUUUUUUUUUUUUUUUUUUUUUUUUUUDUUUUUUUUUUUUUUUUUUUUUUUUUUUUUUUUUUUUUUUUUUUUGGGG
GGGGGGGGGGGGGGGGGGGGGGGGGGGGGGGGGGGGGGGGGGGGGGGGGGGGGGGGGGGGGGGGGGGGGGGGGGGGGGGGGGGGGGGGGGGGGGGG
GGGGGGGGGGGGGGGGGGGGGGGGGGGGGGGGGGGGGGGGGGGGGGGGGGGGGGGGGGGGGGGGGGGGGGGGGGGGGGGGGGGGGGGGGGGGGGGG