GGGGGGGGGGGGGGGGGGGGGGGGGGGGGGGGGGGGGGGGGGGGGGGGGGGGGGGGGGGGGGGGGGGGGGGWWWWWWWWWWWDWWWWWWWWWWGGG
WWWWWWWWWWWWWWWWWWWGGGGGGGGGGGGGGGGGGGGGGGGGGGGGGGGGGGGGGGGGGGGGGGGGGGGWFFFFFFFFFFFFFFFFFFFFWGGG
WFFFFFFFFFFFFFFFFFWGGGGGGGGGGGGGGGGGGGGGGGGGGGGGGGGGGGGGGGGGGGGGGGGGGGGWFFFFFFFFFFFFFFFFFFFFWGGG
WFFFFFFFFFFFFFFFFFWGGGGGGGGGGGGGGGGGGGGGGGGGGGGGGGGGGGGGGGGGGGGGGGGGGGGWFFFFFFFFFFFFFFFFFFFFWGGG
WFFFFFFFFFFFFFFFFFWWWWWWWWWWWWWWWWWWWWWWWWWWWWWWWWWWWWWWWWWWWWWWWWWWWWWWFFFFFFFFFFFFFFFFFFFFWGGG
WFFFFFFFFFFFFFFFFFFFFFFFFFFFFFFFFFFFFFFFFFFFFFFFFFFFFFFFFFFFFFFFFFFFFFFFFFFFFFFFFFFFFFFFFFFFWGGG
WFFFFFFFFFFFFFFFFFFFFFFFFFFFFFFFFFFFFFFFFFFFFFFFFFFFFFFFFFFFFFFFFFFFFFFFFFFFFFFFFFFFFFFFFFFFWGGG
WFFFFFFFFFFFFFFFFFFFFFFFFFFFFFFFFFFFFFFFFFFFFFFFFFFFFFFFFFFFFFFFFFFFFFFFFFFFFFFFFFFFFFFFFFFFWGGG
WFFFFFFFFFFFFFFFFFWWWWWWWWWWWWWWWWWWWWWWWFFFFFFFWWWWWWWWWWWWWWWWWWWWWWWWFFFFFFFFFFFFFFFFFFFFWGGG
WFFFFFFFFFFFFFFFFFWAAAAAAAAAAAAAAAAAAAAAWFFFFFFFwFFFFFFFFFFFFFFFFFFFFFFWFFFFFFFFFFFFFFFFFFFFWGGG
WFFFFFFFFFFFFFFFFFWAAAAAAAAAAAAAAAAAAAAAWFFFFFFFwFFFFFFFFFFFFFFFFFFFFFFWFFFFFFFFFFFFFFFFFFFFWGGG
WFFFFFFFFFFFFFFFFFWAAAAAAAAAAAAAAAAAAAAAWFFFFFFFwFFFFFFFFFFFFFFFFFFFFFFWFFFFFFFFFFFFFFFFFFFFWGGG
WWWWWWWWWWWWWWWWWWWAAAAAAAAAAAAAAAAAAAAAWFFFFFFFwFFFFFFFFFFFFFFFFFFFFFFWWWWWWWWWWWWWWWWWWWWWWGGG
AAAAAAAAAAAAAAAAAAAAAAAAAAAAAAAAAAAAAAAAAFFFFFFFAAAAAAAAAAAAAAAAAAFFFFFFFFFFFFFFFFWAAAAAAAAAAAAA
AAAAAAAAAAAAAAAAAAAAAAAAAAAAAAAAAAAAAAAAAFFFFFFFAAAAAAAAAAAAAAAAAAFFFFFFFFFFFFFFFFWAAAAAAAAAAAAA
AAAAAAAAAAAAAAAAAAAAAAAAAAAAAAAAAAAAAAAAAFFFFFFFAAAAAAAAAAAAAAAAAAFFFFFFFFFFFFFFFFWAAAAAAAAAAAAA
AAAAAAAAAAAAAAAAAAAAAAAAAAAAAAAAAAAAAAAAAFFFFFFFAAAAAAAAAAAAAAAAAAAAAAAAAAAAWFFFFFWAAAAAAAAAAAAA
AAAAAAAAAAAAAAAAAAAAAAAAAAAAAAAAAAAAAAAAAFFFFFFFAAAAAAAAAAAAAAAAAAAAAAAAAAAAWFFFFFWAAAAAAAAAAAAA
AAAAAAAAAAAAAAAAAAAAAAAAAAAAAAAAAAAAAAAAAFFFFFFFAAAAAAAAAAAAAAAAAAAAAAAAAAAAWFFFFFWAAAAAAAAAAAAA
GGGGGWWWWWWWWWWWWWWWWWWWWWWWWWWWWWWWWWWWWFFFFFFFWWWWWWWWWWWWWWWWWWWWWWWWWWWWWFFFFFWWWWWWWWWGGGGG
GGGGGWFFFFFFFFFFFFFFFFFWFFFFFFFFFFFFFFFFFFFFFFFFFFFFFFFFFFFFFFFFFWFFFFFFFFFFFFFFFFFFFFFFFFWGGGGG
GGGGGWFFFFFFFFFFFFFFFFFWFFFFFFFFFFFFFFFFFFFFFFFFFFFFFFFFFFFFFFFFFWFFFFFFFFFFFFFFFFFFFFFFFFWGGGGG
GGGGGWFFFFFFFFFFFFFFFFFWFFFFFFFFFFFFFFFFFFFFFFFFFFFFFFFFFFFFFFFFFWFFFFFFFFFFFFFFFFFFFFFFFFWGGGGG
GGGGGWFFFFFFFFFFFFFFFFFWFFFFFFFFFFFFFFFFFFFFFFFFFFFFFFFFFFFFFFFFFWFFFFFFFFFFFFFFFFFFFFFFFFWGGGGG
GGGGGWFFFFFFFFFFFFFFFFFWFFFFFFFFFFFFFFFFFFFFFFFFFFFFFFFFFFFFFFFFFWFFFFFFFFFFFFFFFFFFFFFFFFWGGGGG
GGGGGWFFFFFFFFFFFFFFFFFWFFFFFFFFFFFFFFFFFFFFFFFFFFFFFFFFFFFFFFFFFWFFFFFFFFFFFFFFFFFFFFFFFFWGGGGG
GGGGGWFFFFFFFFFFFFFFFFFWFFFFFFFFFFFWWWWWWWWWFWWWWWWWWWFFFFFFFFFFFWFFFFFFFFFFFFFFFFFFFFFFFFWGGGGG
GGGGGWFFFFFFFFFFFFFFFFFWFFFFFFFFFFFWFFFFFFFFFFFFFFFFFWFFFFFFFFFFFWFFFFFFFFFFFFFFFFFFFFFFFFWGGGGG
GGGGGWFFFFFFFFFFFFFFFFFWFFFFFFFFFFFWFFFFFFFFFFFFFFFFFWFFFFFFFFFFFWFFFFFFFFFFFFFFFFFFFFFFFFWGGGGG
GGGGGWFFFFFFFFFFFFFFFFFWFFFFFFFFFFFWFFFFFFFFFFFFFFFFFWFFFFFFFFFFFWFFFFFFFFFFFFFFFFFFFFFFFFWGGGGG
GGGGGWFFFFFFFFFFFFFFFFFWFFFFFFFFFFFWFFFFFFFFFFFFFFFFFWFFFFFFFFFFFWFFFFFFFFFFFFFFFFFFFFFFFFWGGGGG
GGGGGWFFFFFFFFFFFFFFFFFWFFFFFFFFFFFWWWWWWWWWWWWWWWWWWWFFFFFFFFFFFWFFFFFFFFFFFFFFFFFFFFFFFFWGGGGG
GGGGGWFFFFFFFFFFFFFFFFFWFFFFFFFFFFFFFFFFFFFFFFFFFFFFFFFFFFFFFFFFFWFFFFFFFFFFFFFFFFFFFFFFFFWGGGGG
GGGGGWFFFFFFFFFFFFFFFFFWFFFFFFFFFFFFFFFFFFFFFFFFFFFFFFFFFFFFFFFFFWFFFFFFFFFFFFFFFFFFFFFFFFWGGGGG
GGGGGWFFFFFFFFFFFFFFFFFWFFFFFFFFFFFFFFFFFFFFFFFFFFFFFFFFFFFFFFFFFWFFFFFFFFFFFFFFFFFFFFFFFFWGGGGG
GGGGGWWWWWWWWWWWWWWWWWWWWWWWWWWWWWWWWWWWWWWWWWWWWWWWWWWWWWWWWWWWWWWWWWWWWWWWWWWWWWWWWWWWWWWGGGGG
GGGGGGGGGGGGGGGGGGGGGGGGGGGGGGGGGGGGGGGGGGGGGGGGGGGGGGGGGGGGGGGGGGGGGGGGGGGGGGGGGGGGGGGGGGGGGGGG