GGGGGGGGGGGGGGGGGGGGGGGGGGGGGGGGGGGGGGGGGGGGGGGGGGGGGGGGGGGGGGGGGGGGGGWDWGGGGGGGGGGGGGGGGGGGGGGG
GGGGGGGGGWWWWWWWWWWWWWWWGGGGGGGGGGGGGGGGGGGGGGGGGGGGGGGGGGGGGGGGWWWWWWWFWWWWWWWGGGGGGGGGGGGGGGGG
GGGGGGGGGWUUUUUUUUUUUUUWGGGGGGGGGGGGGGGGGGGGGGGGGGGGGGGGGGGGGGGGWUUUUUUFUUUUUUWGGGGGGGGGGGGGGGGG
GGGGGGGGGWFFFFFFFFFFFFFWWWWWWWWWWWWWWWWWWWWWWWWWWWWWWWWWWWWWWWWWWFFFFFFFFFFFFFWGGGGGGGGGGGGGGGGG
GGGGGGGGGWFFFFFFFFFFFFFUUUUUUUUUUUUUUUUUUUUUUUUUUUUUUUUUUUUUUUUUUFFFFFFFFFFFFFWGGGGGGGGGGGGGGGGG
GGGGGGGGGWFFFFFFFFFFFFFFFFFFFFFFFFFFFFFFFFFFFFFFFFFFFFFFFFFFFFFFFFFFFFFFFFFFFFWGGGGGGGGGGGGGGGGG
GGGGGGGGGWFFFFFFFFFFFFFWWWWWWWWWWWWWWWWWWWFWWWWWWWWWWWWWWWWWWWWWWFFFFFFFFFFFFFWGGGGGGGGGGGGGGGGG
GGGGGGGGGWFFFFFFFFFFFFFWGGGGGGGGGGGGGGGGGWFWGGGGGGGGGGGGGGGGGGGGWFFFFFFFFFFFFFWGGGGGGGGGGGGGGGGG
GGGGGGGGGWFFFFFFFFFFFFFWGGGGGGGGGGGGGGGGGWFWGGGGGGGGGGGGGGGGGGGGWFFFFFFFFFFFFFWGGGGGGGGGGGGGGGGG
GGGGGGGGGWWWWWWWWWWWWWWWGGGGGGGGGGGGGGGGGWFWGGGGGGGGGGGGGGGWWWWWWWWWWWWFFWWWWWWGGGGGGGGGGGGGGGGG
GGGGGGGGGGGGGGGGGGGGGGGGGGGGGGGGGGGGGGGGGWFWGGGGGGGGGGGGGGGWUUUUUUUUUUUFFUUUUUWGGGGGGGGGGGGGGGGG
GGGGGGGGGGGGGGGGGGGGGGGGGGGGGGGGGGGGGGGGGWFWGGGGGGGGGGGGGGGWFFFFFFFFFF+FF+FFFFWGGGGGGGGGGGGGGGGG
GGGGGGGGGGGGGGGGGGGGGGGGGGGGGGGGGGGGGGGGGWFWGGGGGGGGGGGGGGGWFFFFFFFFFF+FF+FFFFWGGGGGGGGGGGGGGGGG
GGGGGGGGGGGGGGGGGGGGGGGGGGGGGGGGGGGWWWWWWWFWWWWWWWGGGGGGGGGW+++++++++++FF+FFFFWGGGGGGGGGGGGGGGGG
GGGGGGGGGGGGGGGGGGGGGGGGGGGGGGGGGGGWUUUUUUFUUUUUUWGGGGGGGGGWFFFFFFFFFFFFF+FFFFWGGGGGGGGGGGGGGGGG
GGGGGGGGGGGGGGGGGGGGGGGGGGGGGGGGGGGWFFFFFFFFFFFFFWGGGGGGGGGWFFFFFFFFFFFFF+FFFFWGGGGGGGGGGGGGGGGG
GGGGGGGGGGGGGGGGGGGGGGGGGGGGGGGGGGGWFFFFFFFFFFFFFWGGGGGGGGGW+++++++++++FF+FFFFWGGGGGGGGGGGGGGGGG
GGGGGGGGGGGGGGGGGGGGGGGGGGGGGGGGGGGWFFFFFFFFFFFFFWGGGGGGGGGWFFFFFFFFFF+FF+FFFFWGGGGGGGGGGGGGGGGG
GGGGGGGGGGGGGGGGGGGGGGGGGGGGGGGGGGGWFFFFFFFFFFFFFWGGGGGGGGGWFFFFFFFFFF+FF+FFFFWGGGGGGGGGGGGGGGGG
GGGGGGGGGGGGGGGGGGGGGGGGGGGGGGGGGGGWFFFFFFFFFFFFFWGGGGGGGGGWFFFFFFFFFF+FF+FFFFWGGGGGGGGGGGGGGGGG
GGGGGGGGGGGGGGGGGGGGGGGGGGGGGGGGGGGWFFFFFFFFFFFFFWGGGWWWWWWWWWWWWWWWWWWFFWWWWWWWWWWWWWWWWWWWWWWG
GGGGGGGGGGGGGGGGGGGGGGGGGGGGGGGGGGGWFFFFFFFFFFFFFWGGGWUUUUUUUUUUUUUUUUUFFUUUUUUUUUUUUUUUUUUUUUWG
GGGGGGGGGGGGGGGGGGGGGGGGGGGGGGGGGGGWFFFFFFFFFFFFFWGGGWFFFFFFFFFFF+FFFFFFFFFFFFFFF+FFFFFFFFFFFFWG
GGGGGGGGGGGGGGGGGGGGGGGGGGGGGGGGGGGWWWWWWWWWWWWWWWGGGWFFFFFFFFFFF+FFFFFFFFFFFFFFF+FFFFFFFFFFFFWG
GGGGGGGGGGGGGGGGGGGGGGGGGGGGGGGGGGGGGGGGGGGGGGGGGGGGGWFFFFFFFFFFF+FFFFFFFFFFFFFFF+FFFFFFFFFFFFWG
GGGGGGGGGGGGGGGGGGGGGGGGGGGGGGGGGGGGGGGGGGGGGGGGGGGGGW++++++++++++FFFFFFFFFFFFFFF+++++++++++++WG
GGGGGGGGGGGGGGGGGGGGGGGGGGGGGGGGGGGGGGGGGGGGGGGGGGGGGWFFFFFFFFFFF+FFFFFFFFFFFFFFF+FFFFFFFFFFFFWG
GGGGGGGGGGGGGGGGGGGGGGGGGGGGGGGGGGGGGGGGGGGGGGGGGGGGGWFFFFFFFFFFF+FFFFFFFFFFFFFFF+FFFFFFFFFFFFWG
GGGGGGGGGGGGGGGGGGGGGGGGGGGGGGGGGGGGGGGGGGGGGGGGGGGGGWFFFFFFFFFFFdFFFFFFFFFFFFFFFdFFFFFFFFFFFFWG
GGGGGGGGGGGGGGGGGGGGGGGGGGGGGGGGGGGGGGGGGGGGGGGGGGGGGWFFFFFFFFFFF+FFFFFFFFFFFFFFF+FFFFFFFFFFFFWG
GGGGGGGGGGGGGGGGGGGGGGGGGGGGGGGGGGGGGGGGGGGGGGGGGGGGGWFFFFFFFFFFF+FFFFFFFFFFFFFFF+FFFFFFFFFFFFWG
GGGGGGGGGGGGGGGGGGGGGGGGGGGGGGGGGGGGGGGGGGGGGGGGGGGGGW++++++++++++FFFFFFFFFFFFFFF+++++++++++++WG
GGGGGGGGGGGGGGGGGGGGGGGGGGGGGGGGGGGGGGGGGGGGGGGGGGGGGWFFFFFFFFFFF+FFFFFFFFFFFFFFF+FFFFFFFFFFFFWG
GGGGGGGGGGGGGGGGGGGGGGGGGGGGGGGGGGGGGGGGGGGGGGGGGGGGGWFFFFFFFFFFF+FFFFFFFFFFFFFFF+FFFFFFFFFFFFWG
GGGGGGGGGGGGGGGGGGGGGGGGGGGGGGGGGGGGGGGGGGGGGGGGGGGGGWFFFFFFFFFFF+FFFFFFFFFFFFFFF+FFFFFFFFFFFFWG
GGGGGGGGGGGGGGGGGGGGGGGGGGGGGGGGGGGGGGGGGGGGGGGGGGGGGWFFFFFFFFFFF+FFFFFFFFFFFFFFF+FFFFFFFFFFFFWG
GGGGGGGGGGGGGGGGGGGGGGGGGGGGGGGGGGGGGGGGGGGGGGGGGGGGGWWWWWWWWWWWWWWWWWWWWWWWWWWWWWWWWWWWWWWWWWWG