WWFFWWWWWWWWWWWWWWWWWWWWWWWWWWWWWWWWWWWWWWWWWFFWWWWWWWWWWWWWWWWWWWFFFFWWWWWWWWWWWWWWWWWWWWWWWWWW
WFFFFWWWWWWFFFFFFFFFWWWFFFWWWWWFFWWWWWWWWWWFFFFFFFFWWFFWWWWFFFFFFFFFFFFFWWWWFFFWWWWWFFFWWWWWFFWW
WFFFFFFFFFFFFFFFFFFFFWFFFFFFWWFFFFFWWWWFFFFFFFFFFFFFFFFFWWFFFFFFFFFFFFFFFWWFFFFFWWWFFFFFFFFFFFWW
WFFFFFFFFFFFFFFFFFFFFFFFFFFFFFFFFFFFFFFFFFFFFFFFFFFFFFFFFFFFFFFFFFFFFFFFFWWFFFFFFFFFFFFFFFFFFFWW
WFFFFFFFFFFFFFFFFFFFWWFFFFFFFFFFFFFFFFFFFFFFFFFFFFFFFFFFFFFFFFFFFFFFFFFFFWWWFFFFFFFFFFFFFFFFFWWW
WFFFFFFFFFFFFFFFFFFWWWFFFFFFFFFFFFFFFFFFFFFFFFFFFWWWFFFFFFFFFFFFFFFFFFFFFWWWWFFFFFFFFFFFFFFFFWWW
WFFFFFFFFFFFFFFFFFWWWFFFFFFFFFFFFFFFFFFFFFFFFFFFWWWWWFFFFFFFFFFFFFFFFFFFFFWWFFFFFFFFFFFFFFFFFFWW
FFFFFFFFFFFFFFFFFWWWFFFFFFFFFFFFFFFFFFFFFFWFFFFFFWWWWFFFFFFFFFFFFFFFFFFFFFFFFFFFFFFFFFFFFWWFFFFW
FFFFFFFFFFFFFFFFFFWFFFFFFFFFFFFFFFFFFFFFFFWFFFFFFFWWWFFFFWWFFFFFFFFFFFFFFFFFFFFFFFFFFFFFWWWWFFFW
FFFFFFFFFFFFFFFFFFFFFFFFWFFFFFFFFFFFFFFFFFFFFFFFFFFFFWWWWWWFFFFFFFFFFFFFFFFFFFFFFFFFFFFFFWWFFFFW
WFFFFFFFFFFFFFFFFFFFFFFWWWFFFFFFFFFFFFFFFFFFFFFFFFFFFWWWWFFFFFFFFFFFFFFFFFFFFFFFFFFFFFFFFFFFFFFW
WFFFFFFFFFFFFFFFFFFFFFFWWWFFFFFFFFFFFFFFFFFFFFFFFFFFFFWWFFFFFFFFFFFFFFFFFFFFFFFFFFFFFFFFFFFFFFFW
WFFFFFFFFFFFFFFFFFFFFFFFWWFFFFFFWWFFFFFFFFFFFFFFFFFFFFFFFFFFFFFWWFFWWWFFFFFFFFFFFFFFFFFFFFFFFFFW
FFFFFFFFFFFFFFFFFFFFFFFFFFFFFFFWWWWFFFFFFFFFFFFFFFFFFFFFFFFFFFWWWWWWWWWFFFFFFFFFFFFFFFFFFFFFFFFW
FFFFFFFFFFFFFFFFFFFFFFFFFFFFFFFWWWFFFFFFFFFFFFFFFFFFFFFFFFFFFWWWWWWWWWFFFFFFFFFFFFFFFFFFFFFFFFFW
FFFFFFFFFFFFFFFFFFFFFFFFFFFFFFFWWFFFFFFFFFFFFFFFFFFFFFFFFFFFWWWWFFFFFFFFFFFFFFFFFFFFFFFFFFFFFFFW
FFFFFFFFFFFFFFFFFFFFFFFFFFFFFFFFFFFFFFFFFFFFFFFFFFFFFFFFFFFFWWWFFFFFFFFFFFFFFFFFFFFFFFFFFFFFFFFW
WFFFFWWFFFFFFFFFFFFFFFFFFFFFFFFFFFFFFFFFFFFFFFFFFFFFFFFFFFFFWWFFFFFFFFFFFFFFFFFFFFFFFFFFFFFFFFWW
WFFFWWWWFFFFFFFFFFFFFFFFFFFFFFFFFFFFFFFFFFFFFFFFFFFFFFFFFFFFFFFFFFFFFFFFFFFFFFFFFFFFFFFFFFFFFFWW
FFFFFWWWFFFFFFFFFFFFFFFFFFFFFFFFFFFFFFFFFFFFFFFFFFFFFFFFFFFFFFFFFFFFFFFFFFFFFFFFFFFFFFFFFFFFFFWW
FFFFFFFFFFFFFFFFFFFFFFFFFFFFFFFFFFFFFFFFFFFFFFFFFFFFFFFFFFFFFFFFFFFFFFFFFFFFFFFFFFFFFFFFFFFFFWWW
WFFFFFFFFFFFFFWFFFFFFFFFFFFFFFFFFFFFFFFFFFFFFFFFFFFFFFFFFFFFFFFFFFFFFFFFFFFFFFFFFFFFFFFFWFFFWWWW
WWFFFFFFFFFFFWWWFFFFFFFFFFFFFFFFFFFFFFFFFFFFFFFFFFFFFFFFFFFFFFFFFFFFFFFFFFFFFFFFFFFFFFFFWFFFWWWW
WWFFFFFFFFFFFWWWFFFFFFFFFFFFFFFFFWWWFFFFFFFFFFFFFFFFFFFFFFFFFFFFFFFFFFFWWFFFFFFFFFFFFFFFFFFFFWWW
WWFFFFFFFFFFFFWWFFFFFFFFFFFFFFFFWWWWFFFFFFFFFFFFFFFFFFFFFFFFFFFFFFFFFFFFFFFFFFFFFFFFFFFFFFFFFFWW
WWFFFFFFFFFFFFWWFFFFFFFFFFFFFFFFWWWWFFFFFFFFFFFWWFFFFFFFFFFFFFFFFFFFFFFFFFFFFFFFFFFFFFFFFFFFFFFW
WFFFFFFFFFFFFFWWFFFFFFFFFFFFFFFFWWWFFFFFFFFFFFWWWFFFFFFFFFFFFFFFFFFFFFFFFFFFFFFFFFFFFFFFFFFFFFWW
WFFFFFFFFFFFFFWWWFFFFFFFFFFFFFFFFFFFFFFFFFFFFFFWWFFFFFFFFFFFFFFFFFFFFFFFFFFFFFFFFFFFFFFFFFWWWWWW
WFFFFFFFFFFFFWWWWFFFFFFFFFFFFFFFFFFFFFFFFFFFFFFFFFFFFFFFFFFFFFFFFFFFFFFFFFFFFFFFFFFFFFFFFFWWWWWW
WFFFFFFFFFFFFWWWWFFFFFFFFFFFFFFFFFFFFFFFFFFFFFFFFFFFFFFFFFFFFFFFFFFFFFFFFFFFFWFFFFFFFFFFFWWWWWWW
WWFFFFFFFFFFFWWWWFFFFFFFFFFFFFFFFFFFFFWWWWFFFFFWFFFFFFFFFFFFFFFFFFFFFFFFFFFFFFFFFFFFFFFFFWWWWWWW
WWFFFFFFFFFFFFWWWWFFFFFFFFFFFFFFFFFFFWWWWWWFFFWWWFFFFFFFFFFFFFFFFFFFFFFFFFFFFFFFFFFFFFFFFFWWFFFW
WWWFFFFFFFFFFFFWWWWFFFFFFFFFFFFFFFFFFWWWWWWFFFFWFFFFFFFFFFFFFFFFFFFFFFFFFFFFFFFFFFFFFFFFFFFFFFFW
WWWFFFFFFFFFFFFFWWWWWWFFFFFWWFFFFFFFFWWWWWFFFFFFFFFFFFFFFFFFFFFFFFFFFFFFFFFFFFFFFFWWWFFFFFFFFFWW
WWWFFFFFFFFFFFFFWWWWWWWFFFWWWWFFFFFFFWWWWFFFFFFFFFFFFFFFFFFFFFFFFFFFFWWWFFFFFFFFFWWWWFFFFFFFFWWW
WWWWFFFWWWFFFFFFWWWWWWWWWWWWWWWFFFFFWWWWWFFFFFFWWWWFFFFFFFFFFFWWWFFFWWWWWFFFFFFFFWWWWWFFFFFWWWWW
WWWWWWWWWWWWWWWWWWWWWWWWWWWWWWWWWWWWWWWWWWFFFWWWWWWWWWWWWWWWWWWWWWWWWWWWWWWWWFFFWWWWWWWWWWWWWWWW
